dawning	ferrous subzero settler scuffle coverup subtext pretzel pushers truffle ketchup
booting	parades charade archery defaced prepped charmed dracula skyward chuckle huddled
wilding	ketchup charmer subvert repress retrace rooster archery robbers soapbox parrots
chopper	bandaid gassing awfully tanking tabling annuity valiant yawning dunning quaking
potable	surging winking gunning scruffy mugging dunning undying gushing nudging ducking
phonics	extrude betamax fledged equated affable flatter marquee burglar trudeau fuelled
hailing	cowboys bedrock odyssey scruffy specter coverup redress subtext typeset secrete
coexist	garland barbara grandpa wayward jugular alabama awfully anagram annular burglar
odyssey	uniting panning balling vagrant limping burglar gunning hailing bucking cranium
cowboys	fireman draught rigging riveted vetting pinning manhunt penguin drizzle retinal
rousing	hatchet betamax faceted fallacy belated payback beltway affable whacked alabama
matador	peeling quibble chuckle incline kingpin keyless pinning swiping gunning hippies
tenured	scallop somalia malcolm showbiz comical cowboys glacial hogwash gallows payback
varsity	wedlock needled deluded clouded muddled clogged echelon needful bookend couched
acutely	proviso voiding dogging fission pigskin robbing poisson sipping priming spiking
twister	fallacy payback bonanza manhood bologna alabama buyback duopoly boombox paddock
panicky	rosebud emblems subvert foxhole deserts slumber metered robbers feelers settler
quibble	skyward anarchy concord typhoon snowman workman schwarz harpoon orchard hogwash
marbles	dogging dunning undoing uptight gifting conning fudging whining nudging touting
marquis	condone typhoon botched foxhole wedlock devolve needled keyhole blotted clogged
pickled	amorous untruth fatuous oratory snowman transom vagrant burnout bombast bonanza
commode	finnish warring pinball surging hissing unitary salting pitfall snaking tabling
heretic	lasagna unsound sandman bonanza alaskan monsoon bologna soapbox sandbag gallows
manning	excused replete deluded deposed steeper secrete huddled flocked scuttle rosebud
paragon	emblems evicted edifice eyeless sweetly chuckle ductile defused bullies witless
manhunt	scissor pickled presser crooked jobless clogged feelers grizzly grossly reviled
chariot	newness defused fledged deluded needled needful expunge keyless emblems gleeful
fresher	capitol dunning cadmium outback aladdin vatican ducking nomadic abiding nodding
hissing	emerald flatter probate prelude calvary templar cupcake cloaked buyback wedlock
bootleg	scruffy varnish sandman inhuman hawkish uncanny animism samurai skyward anarchy
keyless	zooming bracing iranian warring uniting mugging curbing martini panning harpoon
archaic	newness blunted donkeys stumped stooped boombox muddled fledged nonstop sweetly
thermos	gliding kingpin culling willful napping winking fanning undying uncivil abiding
stopgap	crevice decider uncivil needled luckier rubbery riddled chuckle kindled nullify
goading	scuttle subvert fresher turkeys spectre replete subtext specter scruffy pushers
inhuman	deplore breeder flowery pretzel berserk steeper redress revolve repress settler
pensive	fractal crowbar cutback crybaby malcolm warlord buyback acrobat orchard barbara
confine	upstart sparkly draught wayward jugular burglar ballast smartly skyward alabama
ditched	annular paragon granola masonry barbara lasagna burglar grownup pronoun bologna
alimony	defused subvert redress pushers deserts studded shudder perjure precept presser
comrade	kinship hinting pitting bugging uptight kingpin hissing nullify uniting wishful
clobber	undying mugging standup dawning winking sayings gushing finnish napping hissing
rapture	finnish goblins monsoon shoving hooking fooling conning howling illogic showbiz
minibus	hatchet calvary hatched pharaoh whopper cloaked deplore peacock wedlock preface
upstate	grizzly ironing zooming whining fooling wilding hooking voiding voicing milking
rioting	muddled defused alabama swamped appease devalue scuffle beached whacked scalped
probate	ducking mugging gunning whining culling fudging wilding dunning hugging winking
turkeys	colonia jamming dawning glacial fooling wilding wailing balling manhood nodding
lenient	boombox cowards amorous paddock schwarz shadowy hogwash crybaby sharrow barbara
scissor	manhunt awfully tumbled taunted fateful flannel undated equated muddled mangled
tickled	snowman sharrow pharaoh pronoun barbara bonanza monsoon anagram bonjour paragon
touting	affable parades capella barbara emblems charmed scarred beached calvary crackle
equinox	wayward starchy fallacy schwarz crybaby sparkly skyward scrappy payback fractal
robbing	chuckle seattle eyeless equated fallacy typeset acutely capella muddled vaulted
pitiful	manmade grabber whacked snowman godhead berserk comrade cockney scammer cranked
ketchup	boombox animism manning lagging ironing rigging lasagna alimony bagging dawning
yawning	holdout presser coverup specter secrete feelers shocker redress scuffle chuckle
pollute	raiding swaying jacking rigging iranian fawning whining basking miranda crybaby
browned	pitfall glacial haughty uptight catchup catfish pacific cultist pitiful calcify
feelers	bugatti undying dogging tanning quaking utopian copycat cutback payback abiding
wishful	grandpa tenancy concave payback betamax condone acrobat preteen grander negated
awfully	commode robbers bedrock kinship coining repress crooked dieting chipped redress
deluded	torsion poisons contort transom sacking parting statism varnish stoking martini
calcify	boombox trooper newness rooster stunted tenuous deposed stumped steeper regroup
hogwash	luckier preteen circled termite rectify replete entitle blubber unkempt blunted
reentry	paddock alabama hawkish gallows bookish malcolm willful padlock impious hogwash
burrito	hapless spanked pancake lasagna ageless flannel flanked peaches scammed eyeless
oblique	vagrant schwarz anarchy starchy sandman wayward anagram skyward scrappy grandpa
pickles	manhood foundry untruth bonjour matador wayward affront quattro haughty oratory
impious	cadaver electra blacked fanfare cracker fallacy flanked regency fractal retread
sweetie	jugular jocular dracula foundry manhood corpora babylon paragon unbound uncanny
loaning	prepped stumped perjure deserts typeset ketchup extrude repress perjury shudder
barbell	finnish kingpin phonics nudging sniping fudging fission nonstop hissing unsound
smother	dawning fudging quaking fawning nailing canning fallacy gunning nudging wailing
retrace	milking gliding pigskin spiking wishful minibus kinship duopoly gushing dogging
fudging	peacock starchy crowbar remakes oysters cleaver appease boombox schwarz spectre
cologne	upstart purists thrifty wayward varsity marquis turkish warship samurai barbara
devalue	spiking rigging bookish priming zooming gifting contort showbiz kinship trinity
skittle	barbara wayward paragon boombox pharaoh uncanny anagram orchard unbound bonjour
napping	muddled modesty jobless hemlock collude wedlock subtext torched tumbled truffle
chipped	lasagna barbara bologna workman snowman burnout annular alabama affront jugular
vetting	boombox warlock crybaby cowards orchard dracula fallacy scallop collars wayward
reprise	manhunt boombox fallacy unbound cutback bologna holdout hammock manhood malcolm
lawless	thrifty nudging hugging krypton concord rubicon bigfoot rotting idiotic uncouth
bullies	matador pharaoh manhood paragon anarchy oratory affront orchard contort anagram
drizzle	payback stopgap monsoon octopus boombox outcast typhoon hogwash cutback haughty
peaches	wilding trinity gifting willful nodding dunning foundry milking burnout fudging
vaulted	kinship ironing kingpin pinning poisson sipping monsoon whining boombox pigskin
calvary	pinning spiking heinous memento winking quieted finnish tending detente mugging
snowden	glacial cryptic crybaby calvary catchup liturgy cutback bugatti haughty calgary
capella	undoing dousing tidbits turkish hooking rousing fortify hugging bookish fission
expunge	caloric tidbits royally sharrow fallacy comcast lizards wayward saviors ballast
diggers	hammock buyback awfully babylon catchup boombox manhunt payback uncanny typhoon
crowbar	stunted eyeless liquefy peeping needled gentile gunning impeded pensive sniping
petting	orchard vacuous buyback callous skyward awfully fallacy jocular malcolm alabama
warlord	fittest busting subtext sipping hugging petting minibus pensive incense bugging
grander	willful copilot cowboys cultist pitiful octopus copious wishful showbiz bookish
bashful	kingpin concord pricked weeping decider mending condone denizen coining trinity
moaning	rubbery prepped keyless precept plucked eyeless secrete perjure huddled bluster
spanked	fortify cowgirl liturgy bigfoot thrifty willful illogic burrito grizzly boombox
