reiland	takeshi skywest deckman curiale lodwick merisel shrader foodway camilli skillen
ashwell	adamson pinegar odonald schroll canaday huberty bianchi pastula wangler pherson
langman	steimer croghan helmers hellner budnick portner steidel mulford misener molstad
bertino	refenes ernesto rawding bollier revette langham grassia maassen britian denardo
lorence	caronna goodnow percell bobolas draeger grauman galotti barbero amiably provant
massery	steuber tolland bowring stolley laverty zarcone lexmark dacosta britian morahan
soltero	halfdan hamberg airhart pasteur hiester radovan manhart kidwell takeshi thorman
behrend	beckers portner idleman goldwin theseus porchia caraker bakalar ameline britian
ranieri	casella cafiero authier rogness corrick saenger polland critser padrick bransom
vicente	wilborn excimer proserv carhart nowling bulluck mentzer jarriel hilburn cathers
calcomp	coopman mellick maracle lagasse croghan parslow steimer brewton wellons kerfoot
labelle	schroll nilsson gravino castner galotti hammill skillin cabinda luellen darleen
billips	fishell novello longton lamanna palermo scarola sampsel bankert soliday helland
demello	ventech coutant zellers berardo bollier sentman steuben sheerin comdata dentino
curiale	bourque nowaday molstad netview correll desmith padgett pinkley limpert platzer
maassen	callari redshaw sassano biagini kandler largent wishard orourke olender mulford
adamina	bellomy walcher coderre anstice misener nolette luellen raritan courtis ganster
benassi	newbery rubloff camilli esteves lisette wilberg jacinta squiers bowsher donigan
cabinda	bowsher rumford rollman sarokin harbury botkins cookman attardo bachman seebeck
hedding	theilen labelle haygood bellino rodgers sunlite ranieri wilburn madella wootten
nicklas	hadaway ardelle preslar starlin varisco rayment malcomb backsaw conahan hashemi
fedders	roeland laporte hayford finigan zarcone keville shealey sammons theriot wangler
lessner	minotti stepney padgett probert orourke oetting harrell steimer brickey patmore
arbaugh	burgett imboden lowther fanueil sonnier rocklin galster hineman chipote billips
benesch	radovan porchia pelchat camilli greaney bertels maciver maribel lessner fordice
norrell	botkins locadia beckman meroney staines comdata justman lacasse judkins ventech
damgard	oetting molchan silberg desmith lammers portner helland kreager garsten perrott
berumen	bakkers privett dropkin herlong horacia pasteur mescher lamberg corrick bertels
thayers	perales steuber baggett desmith seibold nolette hamrick airhart hillery lisanti
demonte	akridge condren horacia mittman varrone lindsay eyedrop highley bobolas vicente
hellwig	desmith callari wissing draeger hascall rocklin gascons novotel keicher majerus
bamford	cabinda castoro adamina thayers andrich schroll budlong frevert altfest maribel
seedorf	gascons preslar lodwick peratis bochner xylogic finigan wegmann casiano lenning
brammer	cellini youmans norbeck bourret sonnier coderre walston remmers majerus baynard
recoton	dollens fedders patnode norrell newhall leggett sherard garduno braaten cornall
comella	withrow correll dollins covelli zarling gascons goodhue sassman friedly baggett
eleanor	nowaday unclamp vicente pendril stayton nocella norment ashline pendola covello
willden	soliday challis beevers jarriel sellick siebert salawah otology fortney wallach
sheline	goodkin friedly lavette hindley boehler wishard croghan skillin storfer covello
lapenta	calland soldano pollino parslow maassen corsaro deramus lowther jaegers parpart
lemonds	outgain markley pendola ameline rexford servico excimer lingard pinetta fortney
goodhue	ammeter airhart youmans kindran helmers jacinda carwell collomb rawding willden
laforge	lisette donilon sadlier chronar fillman castoro marsden kaplain walberg ketchem
kappler	sellick jacinda ernesto lenning courtis authier pendell reiners tranter ganster
sitrick	lanolin conniff svenson kreuser berumen damaris toyotas levings gauchos behrend
newmann	meiring keicher cropsey wanless fortino helmuth lapides collomb majette lanolin
desmith	heacock nolette parsell rudelle schrick baswell curiale hilburn roseman wilburn
laprise	castner levitan karlsen provant olender sneller schrick minturn shehorn crevier
cantlon	longino stroman weekley parpart deckman whatley millner platona dentino torstar
gravino	frevert plotkin calcomp ernests galotti collomb goodkin critser carwell rubloff
greenan	andoras larison burgman stepney madaris weekley winsett vestron procida melillo
lockamy	denholm deberry baggett haydock lentine desmith rodwell witchey ketchem magwood
kreager	pendril hilburn anstice garrell hermina kliment trester paretti condren greenan
decosta	koppers scarano rockoff forshan filenet scanlin silberg lamanna highley berwald
millner	obregon camilli varrone bransom westpac garduno silberg latrone covelli quirion
cellini	kuipers lexmark excimer parcell calcomp strollo werling miniard wilborn garrell
naslund	dollens willden brebach skillin comella winfrey tribull molchan lockamy judkins
colcord	theriot firmans ingalls coralie lamberg hermina levings meiring worrell medaris
giscard	wishard hadlock xylogic roseman norrell lowther preslar nickell labelle hingham
latonia	salawah watrous oilwell eleanor britian pinkett basilia steeton sowards levings
simkins	servico bertino rediker buening macchia pinkard sneller portner newhall winings
knudson	marucci sowards soliman kliment parslow samford canwest hadlock herbeck stanard
kenrick	jacinda conolly chipote coopman sellick vicente padrick basquez rediger hellner
chatwal	melwood crimean heacock knipple marcott laforge aquinas cookman weekley galster
greaney	calgene probert goodnow russett planers levitan kerfoot larison conolly soldano
chatmon	willits sandall raritan bertino helmers koranda redmund stitzer ashdown gauchos
dollens	mayland withrow weekley pasteur stammen sonnier greaney conniff merisel newcome
cutworm	comdata porchia burback winsett stroman casella excimer herbers rozelle conditt
shealey	refenes rushdie pherson bankert fraizer vallery energas gwinner ameline hulings
attardo	lugworm fordice normile sheward silberg mentzel bainter percell squiers tabbert
hamberg	steuber kilborn hascall chisman gunnels angerer campton culbert stormes svenson
rendell	weekley kalbach baynard sentras rivette provant hindley naumann otology dishong
shetter	majerus stroman huberta lemberg largent stanard vitullo rusconi withrow wanless
bartram	takeshi barrera stammen sunlite raritan rogness scianna witchey silberg comella
delatte	moretti padrick hedding helland hellard sansone manhart svenson haygood jacinta
tribull	curlett condren manthey damiani kenward casiano fabiano beckman kenrick akerson
newbill	natwest parslow selberg alaster marbach cornall parsell critser norment basford
petties	mariani meroney redshaw challis laporte chanley percell provant pentech greenan
bachman	redmund unicorp mulhall giscard petrina dishong pinelli goodine bakkers galster
ganster	polland brittan halpert millman navstar lapides courtis sherard rediger mannion
rediker	berumen bellomy brickel markley kreager stepney laprise iddings janisch maassen
procida	folland walenta calcomp kenward koranda misener printon marketi jacinda capshaw
preslar	baswell chatmon wampler steeton newbery canwest goldwin housand matthis haseman
newcome	boykins corsaro gerster scarbro seelman burback silcott heroize obregon wissing
bedolla	seibold ketchem ventech hellard emogene mistler verbeck challis oilwell lenning
ragavan	querida tolbert steeton berwald newhall goldson tabuchi savidge fortino bertini
stelian	malcomb berwald lerette galster zellers luellen aransas correll finazzo walmond
holmium	stelian alaster altizer hiester botkins chanley arbaugh wallner quilmes janisch
vanaman	benesch lindsay harvell tabbert markson biagini glennie remmers carrell campton
angelou	galster beltran svenson firmans vitullo greaney marbach jarrell nolette bertels
latrone	housand lacasse rendell marcott percell querida tarbert stolley tribull cardosa
dalbert	troiani hingham brammer fellman melchor wilburn draeger halpert hanigan durette
hollick	lisanti forquer playtex sherlin zarcone hackley condren brickel lapenta seedorf
mainard	chatmon knipple honasan altfest molenda oilwell lowther plotkin barcomb lagasse
molstad	nickell deptula nolette mulford rockoff accardi lamberg platona salberg durette
encinas	palermo selberg imboden bigeyes curiale chatwin sampsel britian hadlock rackley
ruseler	denardo cerullo haseman hindley boehler moonves pinkard yearago costano bochner
highley	brittan manhart goodhue hayford laprade mentzer abascal wallner newbill stoever
schamel	steimer damaris newmann brittan lagasse demeree crevier palmore massery humulin
idleman	mulford conolly kelemen toyotas ranieri lammers mellick amiably canzano barrera
