starman	worlder hippest widener moraine vornado conaway funnels dockery statham affably
marling	bayless peppard haywood frannie grassel rainier heighth alliant linings metrick
laureen	kreuger amenity ferries wilmore edelman durning recross facials exabyte boatman
lucking	honoria templin cinched legwork feeback tippers galasso trounce rainier automap
adelson	logicon flushes palumbo orbited chiapas sieving brecher impanel metrick pinette
pillard	psalter madison lillard bolanos clouser flippen drucker pradesh breaths samaria
facings	ventral sunfish crossin kristol zealand orasure demming metrick whiston planter
knowles	colonna cordier bedford menning blahnik gradate richter warmish prebble curless
sunward	hackney territo stannie froning germani delores entwine debussy redeems carbine
grandin	matthew maquila addison imogene jangled germain smalley galilee hamlets summits
hardens	hamlets octaves anaheim outguns yummies eyelets shellac brasher lowborn lauding
bonanno	fortier connors sassoon salerno wolfing buckles harland sanford leandro flippen
orbited	cordier herndon contran warbler chatman dieters notches joinery swenson styrene
antwerp	conover cresses compote adjudge primark avignon marcell paramus vasquez warmish
devault	neville parness leaming manfred hardens slusher edwards bowlers psalter livings
dicarlo	parrott chiapas squatty perseus norfolk snifter chugged twigged gerhard sandhog
commack	hashers squatty thereon scupper reoffer hackney parkers andante condors maquila
cornell	camorra ignites hillock cresses bourses partain prescot condors peacher warwick
bangkok	hillman gyrated hallock grandis jillian wringer bayless panetta wapping katrina
sterner	speidel stowell dispair hardman madding jesuits froning cheever fallows glendon
raisers	batiste handley merieux fairlie legault bonnell forgave bessler despres grantor
monomer	reicher denault cockles gravest comfrey imamura lookers herndon palumbo scupper
bayonne	switzer opining organum studley portend barbers comfrey wooding pentane geeting
walnuts	impanel hashers imogene wilfred achille piccola martina outguns conifer facials
outguns	rolltop bolanos salerno melanie mistook leister lookers spacers wooster adjudge
philips	modesta notches walnuts ridable bencher quavers pentane flagler nicolas durning
bossman	brinner prances paramus stowell melrose walnuts slusher tatiana facings antwerp
prebble	mattern rhodium paramus marcone majesta jourdan firkins blander rowboat anthill
brabant	drizzly constar glidden leister minuses blizard salerno summits coursey revamps
wellman	swished stabile marcell caprica hatcher drucker chugged cinemax mercier candler
allayed	millets spacers refills banbury revelle legumes powders spruced charlot bernard
broking	nonbank norfolk ballmer andress carsten lucking thereon stender warners leaming
buckles	samaria peacher stender conveys bicking funnels outsold deblock hillman smither
diebold	whooped financo ashland meiosis warners sheffer stender miscues drooped trumble
geeting	stephan manheim chemise cringed cheever justina retinue outsold dickers chatman
carling	whinery puentes lechner madding villard volleys orasure fallows spruced earplug
aground	bonelli classen debussy lacoste thereon hadrian dimmers cringed frances schneck
orasure	boswell galicia corsage skelter sparred elicits brickle ventura madding snacked
laurent	sampans offerer schwind chilton pradesh philips jangled welcher rideout twigged
pushups	stennis markups hillman guesser howland freitas addison peacher renault prances
swingle	fibroid mansour frogmen squatty rideout wending katrina zealand avignon playpen
bangles	incisor croaker conveys garissa chaucer capoten blizard debussy hardens contini
mariana	nickles leaches wilmore adelson divests rudyard refills wringer choicer maclean
carlock	logwood christy rattles nonbank bangles carsten redford funnels pedaled hallock
sabella	horacio colling stabler outsold forceps stangle espinal saville contran wasatch
christi	frogman nestles harring pinkest broking vasquez hatreds rockman foremen giessen
cringed	blowers whinery lillian warmish perking perseus hackney hadrian avignon grobian
ladling	garling burnham lancers salinas candler wilmore augusta nighter exabyte outpace
clifton	biochem kapusta diverts commack cringed conifer johnnie howland cresses warners
swanson	piglets nestles stoller yearned blahnik storrow contini fishman shuster edelman
oftener	manfred humfrey isomers foremen chivers boxcars quavers starker karsten piously
assails	welcher jurists quinton messina monreal manlove solvers brasher magness burnham
woodrow	pillard ballmer mirilla whipple octavia peppard caprica garlick lacoste dieters
mansell	blueing everman tristan blander boatman sargent sarasin killion parrott grandin
garling	madison berwick spenser marling warmish markham anglers moulder earline dingham
portent	tillery stangle spacers bonnell piglets speidel cutaway ascends stiller strolls
perking	dingham redound slusher portman granito dickers fairlie oversea walkman boatman
playpen	uptrend assails glendon chitter medford sellier bellamy retinue reoffer termine
mongeon	seclude dilling staters hardman andover hillman menning opining cockles grandin
hearths	maybury werking rosella harland garrott constar partain hillman entrail theodor
enthuse	exabyte bolanos wellman bonanno ascends archway readmit miscues swenson richard
hermine	marbury biochem grindle welcher textron parlays hardway peruses sunbeam confers
roseate	rainier berwick jamison jesuits outlive inflows fransen carsten sandhog whipple
candler	sandhog fixings blueish hayashi leandro mansell corsage clemons valeria stender
melrose	drawled rolltop powders thorton snaring roister hashers kleiner widener primmer
hamlets	adjudge atlanta brecher palumbo newsman bircher sterner cordell marcone mattern
bonnell	everman rudolph tidwell ridings divests delisle clammed sideman hubcaps hermine
sharpie	haulers cordier kleiner marcell blander germani splenic shuster namibia groaned
conover	lockett mishear rockman corsage valable speakes granito sieving suitors burnham
bilings	bayonne bencher jillian forster dilling dockets sparred sieving ferries jurists
camorra	energen airfoil machado drooped rankles sandage derring regaled bayonne chennai
choicer	metlife wilfred presson piglets festiva vanilli channon blocher bernard wasatch
portend	harking delbert chivers joinery dippers ridings rolltop frogman swingle armoire
chaplin	orators bossier refills contran hadrian majesta powders magness shaffer chilton
romaine	sunbeam boswell splices stubbed cynthia avignon chemise perking hangers piglets
madding	diebold herrick drooped hangars metrick nicolas compote smither howland jesuits
andante	regaled jesters tatiana spangle zealand legault endures dangelo hashers halifax
grantor	grindle rolltop achille raveled delling wyoming wearers carsten stenger colling
revelle	legrand markham rankles shriver cringed hillock mongeon powders ridings careens
whinery	airways mahoney lockets secunda prebble brinner martins choicer summits lucking
palance	piccola funnels sideman wooding uptrend miscues giessen linemen scottie rockman
samaria	condors stowell resende uptrend monomer parlays diebold philipp headley legault
reisman	ramirez creoles peruses atlanta stowell forceps bonnell ladling octaves mensing
rilling	flagler contran sarasin capoten needler schwarm fessler despres legault parness
rudyard	hanners lockyer snagged airways brinner sanford modesta hamlets rowboat insures
dusters	retorts cropper grindle plucker romping buckles clifton wooster eyelets strayer
stubbed	nonfood backman cookers demming mathers sistine rudyard presson rowboat staters
primmer	schiano stocker imamura cynthia shipman sabella martech lillard skywave earhart
denault	brasher hornets coracle whinery granito shuster borland benzing bowlers killion
germani	leister millers foliate dorough readmit pentane studley chatman delisle fishkin
markoff	despres imamura volleys tripoli airfoil marotte commack chemise hessian marston
parrott	neatest catania melanie ferried addison financo romping commack criddle whooped
mathews	splices cinched whiston worlder wallick whinery shipman whipple neville facings
parness	whooped reisman invitee careens dickers stabler lauding prather venable kristol
manfred	cordier comfrey refills uptrend boxcars moralez warmish convery belfast bolanos
yearned	swensen mathers norwood outsold blizard bangles offerer swander ridings straley
germain	banbury fetches breaths purveys topanga carbons crossin stannie summits sunroom
pentane	convair hatreds borland bossier stocker puentes schwarm stifter anthill stennis
caprica	thorton burrows bruster wasatch partain welcher shaffer tenures isomers whooped
metrick	airfoil anaheim dippers welcher tankard slugged vasquez cynthia ruffles denison
