flagler	mistook thinkin schwind cutouts quinton whiston shinsky upticks pushups contini
legault	fibroid norwood schwind condors connors shinsky poppins firkins crossin nonfood
howland	pressey feister reuters merieux tetrick biggers cresses burress buffett mutters
tetrick	sassoon huffman sampans howland bolanos lapland galasso pullman affably nonfood
decodes	mariana malting brabant philipp miramax hillman markham mikhail martina lillian
cinched	burrows komatsu orators rowboat paramus parlays squawks garrott augusta maybury
langton	redfish preceed burress chemise freddie primmer merieux scupper redeems bickers
vanilli	prescot dusters woodrow coursey cresses forster burrows dockery decodes spruced
ladling	cutters estrous cresses brecher burress coursey bettors retorts wooster teeters
airways	nonfood deblock quelled bonnell buffett logbook chunnel lockett connell boomlet
leeming	squatty hydroxy orators burrows wasatch carjack rowboat archway kapusta ashwood
redeems	topanga nonbank nanjing cutaway contini hancock channon hillock libbing wallick
smatter	colling dilling libbing killion nonfood opining wooding lucking hillock logbook
imogene	bulrush squatty wallack cutaway squawks kapusta archway wasatch cutlass washtub
paramus	invitee lionize johnnie chilton logbook wooding henning tidwell glidden bicking
blowers	chadian cynthia tatiana madding thinkin catania dingham macadam chatman gadding
handley	jurists mistook burrows summits storrow cutouts upticks outgrow portico suitors
paneled	storrow burrows schmitt suitors christy summits schists cutouts fourths outgrow
wyoming	barbers delbert teeters chaucer belarus curless burpees flushes brasher hatreds
haberer	woodlot logicon lucking fixings killion upticks simplot summits nonfood outguns
portico	langley skywave funnels wellman angeles sunbeam sabella squawks swensen smalley
everitt	claunch lapland haywood hallock macadam flagman bookman channon backman colonna
revelle	channon squawks huffman schuman shinsky antonia hubcaps canucks namibia madison
rideout	malayan walkman skyhawk wallack flagman canavan cabanas affably backman sampans
sonatas	merieux plucker drucker revelle reicher chugged ferried preceed brecher pickier
nestles	warwick primark carjack rhodium camorra ricardo hydroxy commack richard markoff
storrow	canavan galilee benning chugged quelled langley achille mikhail huffman demming
automap	ferries criddle brickle biggers swingle cringes nickles ferried berwick giessen
boswell	miramax tatiana chadian mariana katrina markham madding rudyard dingham ganging
yummies	bonanno nonfood norwood channon contran grantor granato carlock nonbank logbook
stoller	windham chadian backman nanjing gadding madding wapping huffman ganging namibia
grantor	splices chemise celsius piddles pushups delisle miscues debussy whipple seclude
carissa	woodlot mongeon quelled logwood buffett bonnell boomlet logbook nonfood whooped
gerlich	bookman bossman kapusta komatsu squatty sampans squawks automap sonatas footman
madding	welcher slusher schloss ruffles solvers buckles cutters eyelets burpees jesters
richman	boswell eyelets slugged logwood buffett volleys lovejoy logbook stubbed woodlot
zealand	fourths christy schmitt cutouts burrows mistook schists christi jurists upticks
legwork	catania statham sampans summits schists hubcaps justina cabanas squatty hayashi
mensing	woodlot rudyard parrott charlot woodrow cutaway carjack carlock rowboat rolltop
sterner	hillock domical willowy vigilia maquila halifax validly mikhail commack palumbo
offerer	anthill wasatch augusta validly skyhawk pushups atlanta cutaway lauding namibia
fortier	canucks ashland cabanas malayan landman hubcaps backman wallack canavan macadam
waterer	logicon fixings linings killion logbook opining bicking piously livings bilings
freddie	automap outlays cabanas hubcaps palumbo komatsu schuman outguns atlanta channon
zipless	mandato banbury bangkok conaway rowboat hancock archway marbury channon cutaway
markups	whitten henning glendon woodlot benzing logwood bellini entwine teeling cinched
wallack	territo benzing ferries infuses sinuses humfrey pinette diverts bettors romping
nonbank	despres philipp cellist primmer christy tippers millets dieters dusters zipless
diebold	sampans statham carjack augusta archway skyhawk wasatch schuman huffman hangars
bonanno	fetches schmitt humfrey metrick flushes pickier redeems silvers limpets estelle
burnham	dispell fillies piddles delisle dockets lovejoy logwood tidwell estelle cockles
squatty	conifer pickier needler broking cordier herndon bencher norwood flippen wilmore
ferrier	colonna hubcaps langton skyhawk washtub lapland bolanos galasso swanson pushups
tumeric	ashwood swanson haywood howland bonanno bolanos logbook sassoon lapland logwood
augusta	brecher whipple mencken whinery redford reicher convery willowy brinner bonelli
beacher	opining livings outsold woodlot summits politis mistook dilling piously splints
retorts	chaplin maquila lauding huffman dingham wallack lamping libbing galicia lapland
simplot	beacher chaunce gaucher rudyard haberer banbury charney yearend andrade brecher
facials	uptrend mongeon portend redondo energen thorton newport herndon thereon drooped
geeting	mallory palumbo commack marbury hallock skyhawk carjack macadam markham bulrush
cutlass	demming werking hydroxy redondo widener froning frogmen whinery herndon broking
loopers	catania macadam huffman cutaway chadian thinkin madigan namibia bicking tatiana
warbler	opining nonfood poppins thinkin summits schists shinsky contini mistook fishkin
caskets	fibroid logwood norwood fillion froning dorough hydroxy rilling woodrow romping
logwood	harrier prather bickers anaheim patchin vasquez huffman recites materna freitas
graders	thinkin hillock quinton clifton killion willowy contini fillion philipp chilton
teaster	bicking fillion dilling nonfood logbook logwood killion lucking logicon opining
corolla	newsies whitted pinette jesuits fishkin menning invitee summits demming benzing
teeters	bookman namibia haywood backman galicia palumbo blahnik bonilla logicon nanjing
frasure	chilton logbook thinkin bitting contini wyoming opining woodlot logwood colling
gyrated	hillock poppins inflows schloss fillion sunfish philipp philips pushups fishkin
estrous	lillian malinda wallack chadian bicking libbing mikhail blahnik chaplin validly
grindle	komatsu squatty skyhawk washtub commack wasatch cutouts pushups kapusta squawks
kreuger	alliant nicolas malinda atlanta fillion malayan chadian diatoms hayashi chaplin
cutters	wolfing bonilla killion madigan willowy nonfood lamping lillian bonanno mikhail
worlder	tatiana chiapas sunfish huffman schmitt schists augusta facings hubcaps upticks
ruffles	madding bonanno wapping haywood boatman commack backman tatiana catania contini
manfred	schloss cutouts philipp schists upticks philips willowy piously pushups politis
cabanas	kreuger willowy ferrier wilfred outlive whipple dorough fortier redford worlder
rudyard	henning swenson hemming compote nickles killion menning heighth moslems inflows
fallows	mencken gingery cinched cringed merieux bitting invitee thinkin nighter chugged
barbers	lucking willowy chilton clifton logwood wyoming thinkin dilling opining logicon
incised	rolltop markoff garrott affably outgrow logbook parrott palumbo maybury mallory
solvers	nanjing cutaway backman tatiana bicking ganging chadian catania bitting dingham
overton	mikhail squawks philipp salafia pushups skyhawk galicia assails philips affably
fillies	rockman markham dorough raymond granado rowboat bookman automap maybury garrott
richter	swanson malayan bookman pullman galasso bossman fallows nonbank landman sampans
ashland	tumeric rectory territo offerer metrick pickier ferrier reoffer merieux cropper
clifton	harders perused vasquez hashers burgess speakes pushups haberer edwards peppard
wapping	fourths eyelets cresses outsold humfrey redford redeems bessler bulrush seclude
bonnell	cutaway upticks casimir rudyard markups carjack richard miramax schwarm samaria
meiosis	hardway wallack brabant canavan cutaway atlanta lapland banbury rudyard claunch
palumbo	recites freddie stenger widener richter ridings ignites knicker steffen schists
edmonds	halifax vigilia railcar galicia cutaway carjack caprica warwick garlick archway
norther	squawks wallick macadam galicia validly vigilia salafia assails affably facials
financo	trumble skelter quelled shuster redeems turrets revelle slusher debussy bruster
lauding	storrow wooster jesters rooters recross cheever therese compote bettors fetches
mongeon	bacardi skyhawk archway hardway squawks wallack dispair carjack richard plaudit
delisle	banbury chatman grantor markham granato brabant camorra thorton outgrow formant
norwood	cuticle elicits facials belfast eyelets metlife smalley sabella philips cutlass
