weekley	barcomb maranto dimaria naumann raritan rumford giscard corissa athanas passaro
manhart	sellick woolley popwell keville doswell covello weekley willsey kidwell bulluck
mittman	kerwood selberg eyedrop doswell respess roussel bedwell fedders hogwood orourke
reddell	gascons coopman botkins finazzo southam chatmon costano canzano sassano campton
roussel	canaday damiani bachman bianchi biagini hanigan finigan vanatta adamina cabinda
mengers	covault chatwal bulluck vitullo hollick hadaway daquila foodway lodwick tabuchi
skillen	foodway carhart barcomb parpart armwood rayford harbach rutgard hayford comdata
demisch	provant tarallo longton bakalar vanatta quotron ragavan otology granoff platona
mulford	pagette pinetta nesseth skywest seebeck netview staines antenne vicente vanatta
schamel	bowring goodnow dropkin quirion fortino winwood goodkin winford buffkin quotron
hashemi	bulluck otology rockoff budlong quotron goldwyn longton goodlow goodnow colcord
vasques	longino bowring colcord minotti hollick kilcoin donilon linford kilborn fortino
willsey	rumford coopman manford damgard harbach okamura fortman morahan marzano burgman
moretti	wallach hadaway abascal calland bulluck halfdan salawah capshaw kalbach naslund
mentzel	arbaugh grassia porchia basford rayford corsaro corrick hadaway giscard procida
luellen	corrick haygood scarbro withrow basford sowards matthis damaris castoro dacosta
novello	marbach dimaria massari buttars damgard bartram accardi schrick sitrick grassia
granoff	keswick lisette seebeck billips bulluck ketchem helmuth steidel demille bedwell
filenet	marbach harbach armwood goodbar majoros backsaw burback hadaway haygood gauchos
fortman	phillis pickell buswell keswick willsey kidwell billips bigeyes sellick hellwig
bullins	pagette carhart revette kerwood provote armwood heacock verrett haymore redeker
perrott	salawah finigan scanlin canaday iddings chisman daquila ingalls millman janisch
adamson	bulluck rivette revette zwicker verrett keicher culbert highley keville crevier
kaplain	bourque touchet huberty rodgers dresher reddoch bourret streett durette cutworm
lagasse	cornick rudnick montroy cutworm quirion quotron corrick printon howorth budnick
machida	streett skywest respess provote burgett bourret wellons refenes novello josette
highboy	antenne fellman deramus vanella sandner carrell parpart karlsen streett arnette
walston	redifer verburg pedrick riviere rediger rediker kreider crevier demeree fedrick
lanigan	kerwood sumpter steuber shetter kreuser skywest rexford huberty bourret storfer
frieder	athanas langman cantlon campton pastula youmans malcomb canzano polston backsaw
adamina	beckers verrett hollett streett storfer reuther powless esteves forquer kreuser
zellers	campton haydock coopman highboy mannion naumann hanigan mittman coutant hadaway
lugworm	esteves staines seebeck vanatta achieva desanti patasse pinetta devaney hideaki
skywest	garduno finigan rubloff jacinda arbaugh mariani mainard zarling accardi lingard
pollino	harbury redshaw kreager gerster quesada tarbert heckard badgett deavers reuther
ernesto	limbach bulluck mahalah daquila hadaway kalbach hammill wallach mulhall macchia
andrick	stolley leggett josette mozelle popwell mollett bellomy esteves hollett theseus
kerwood	hanigan camilli scalisi lamanna vanaman mulhall fantail challis justman unclamp
aransas	melwood pickell mollett highley popwell hollett kidwell petitto lodwick hellwig
minchin	pasteur dalbert perrott kerfoot galster parpart alaster durette rodgers baswell
garrell	conniff buffkin winwood conditt vinicio townson judkins botkins simkins boykins
preslar	conditt budnick minchin minotti vinicio goodnow conniff buffkin goodkin winwood
merisel	canzano haygood coutant canaday foodway goodnow hadaway nowaday vanatta conahan
revette	naslund basilia hammill aquinas schillo honasan hanigan lindsay daquila macchia
winwood	russett theseus percell carhart pagette barrera becraft bulluck cheetal preslar
tarallo	eddings buffkin benesch hedding buening bigeyes iddings judkins minchin bensing
locadia	verburg sumpter bergren burness newbern mengers evensen respess steuben frevert
fortney	limbach basilia scalisi wallach salawah phillis camilli challis mahalah hammill
rusconi	bagwell labelle bedwell pagette mahalah majette whatley badgett delatte padgett
watrous	nickell lenning mellick kelemen kindell pinkley demille pickell cellini gehling
lemberg	chatwin foodway conditt jacinda conahan sassano ashdown canzano coutant scianna
callari	nesseth stepney edmundo newsome wootten goodhue townson johnsen skywest hogwood
petrone	camilli limbach backsaw basilia amiably salawah daquila mahalah hascall challis
buffkin	wallach massery hadaway cardosa trester scarola worrell zellers jaegers dossett
woolley	buttars manhart rudnick padrick firmans vanaman massari adamina accardi matkins
knudson	beheler achieva labelle airhart vallery recchia whatley pelchat hammill tarbert
rayford	quilmes kelemen skillin pentech keswick sunlite theilen wissing sellick henline
branner	goodlow willits schillo phillis holmium colussy vitullo hollick silcott xylogic
takeshi	lugworm budlong mulford goodlow conolly rubloff colcord goodnow goldwyn collomb
caraker	goldwin holmium phillis goldwyn nilsson goodlow minotti highboy townson dollins
basford	highley mentzel pinkley keville pinelli minchin pickell helmuth klement mellick
limbert	goodnow gauchos hadaway haydock sassano conahan canzano honasan nowaday ashdown
wilburn	dossett pagette majette haygood copetas dacosta toyotas ketchem heacock haydock
carrell	wissing winwood goodkin dishong boykins judkins hogwood goodnow knudson simkins
withrow	basquez calland vanaman unclamp labelle gunnels luellen seebeck deckman sampsel
klement	scarbro corissa basford harbach rayford varisco giscard accardi capshaw grassia
ventech	basilia parslow assuras passaro rubloff palomba rumford lugworm grassia soliday
numidia	beevers shetter worrell herbeck cropsey soltero otology bowsher percell lowther
salawah	quotron benitez verbeck rivette riviere kreider connett emogene fortney correne
helmers	canaday donigan finazzo conditt canzano outgain vinicio jacinta cabinda goodkin
bronder	matthis alquist hammill hascall mahalah scalisi pastula camilli salawah willits
meroney	chatwal alquist daquila basilia abascal billips kalbach wallach bulluck tabuchi
goodbar	henline quilmes sunlite sellick phillis menuhin skywest ventech willsey klement
rozelle	matkins biagini chatwin chisman hanigan adamina hadaway jacinta scianna machida
donigan	streett curlett beckers lerette bertels frevert beheler sumpter remmers verbeck
scanlin	forquer orourke kerwood verrett verburg frevert demeree kerfoot redeker eyedrop
marsala	goodine goodkin buffone dentino witchey benitez budnick winwood petitto ventech
lavette	wissing judkins dropkin knudson winings bowring unicorp rockoff grisson highboy
kreider	cantlon mahalah gascons sassano naumann chatmon athanas longton vanaman southam
rediger	vanaman malcomb hascall walston campton collomb lamanna coopman wallach unclamp
minturn	seebeck goodlow schwake casella heacock kalbach salawah capshaw baswell hogwood
wilborn	pagette esteves matthes majette vasques ketchem patasse quesada padgett theseus
collomb	rediker ragavan rushdie aransas stanard squiers sandvig ranieri athanas skywest
samford	theilen cellini belnick bulluck nickell luellen buening keville gunnell witchey
kerfoot	hingham machida landini ingalls millman hammill mahalah bachman biagini philana
baggett	linford corrick milhorn skillin kilcoin rudnick winford schrick winwood unicorp
kreiser	allmond collomb platona wallach unclamp palomba langham foodway haygood walmond
sherard	kilcoin minotti xylogic longton nowling pollino conolly conniff vinicio otology
quesada	rocklin longino conolly kilcoin nowling xylogic withrow otology highboy plotkin
firstar	melwood newcome colwell mozelle bulluck collomb longden kelemen gunnell kenwood
imboden	pastula carhart wallach salawah hascall chatwal haraway assuras parpart capshaw
newsome	rutgard bakalar ficarra burback accardi hillard parpart daquila arbaugh carhart
mainard	stolley seebeck skywest leggett powless covello buswell touchet popwell esteves
burback	deponte nesseth phillis goodine pinelli mollett nowling glennie montesi minotti
horacia	esteves kelemen skywest mentzel luellen gunnels gunnell klement pendell evensen
philana	bourque cutworm formoso coderre seebeck kerwood dossett royster seedorf skywest
airhart	melwood goodlow connely lemonds bulluck buswell edelson conolly demello emogene
cardosa	klement pinkett mentzel henline lentine pinkley weekley keville knipple menuhin
curlett	finigan biagini simkins dishong hingham adamson sandvig hanigan vanaman mannion
bobolas	rediger pentech ventech keicher demeree frieder excimer durette ketchem gwinner
