gpt-3.5-turbo_prompt_capital_first_acronym1_stratsingle_common_common	gpt-3.5-turbo_prompt_capital_first_acronym1_stratsingle_common_rare	gpt-3.5-turbo_prompt_capital_first_acronym1_stratsingle_rare_common	gpt-3.5-turbo_prompt_capital_first_acronym1_stratsingle_rare_rare
wdorekersetrsl	worlkerset	netlike	netlike
ceilings	ceilingling	vigasageqs	viseagetse
minutests	minutest	restyled	resltyyle
leggally	legraly	havengin	havening
statedmute	statautet	lotsuse	lotsusesn
surpluss	surpluss	sonship	sonship
pariatis	partireseqs	flantgegr	flangere
pasasagege	passage	landers	landersedgrs
samplled	sampeld	alternate	alternate
whedrein	whenever	negasatse	negatetes
domais	domanaimns	geniseta	genius
sharing	sharings	groupese	groupes
regency	regentcy	puttertes	putterset
heights	heights	asundenre	asundercer
mateschedef	matchede	relaction	realati
reclaims	reclaim	defaamed	defaemed
covvered	covered	relight	relight
herself	herswelef	decalaim	decleaiclam
medical	medical	prattl	prahttle
proveokenc	provoke	opertantrana	opernart
hostile	hostile	redlim	redlinie
lockout	locout	servey	smartvery
sighting	signal	shivemers	shiverer
alternated	alterrged	restful	restful
readaches	readacohed	remont	remount
reality	reality	forreamarchc	foreracerca
concerned	concert	spanner	spanneer
linesaget	linenagae	cadeny	cadency
prevent	prevent	currie	curiresi
protest	protest	restyler	resityale
drivester	drivertires	modeler	moderegle
overseer	overtsers	alternate	alternate
printemer	pritnitero	earlees	earls
printers	printer	plugins	plugingis
heighhts	heightstsp	assmenet	assmen
enforece	enforcer	turners	tureners
viewers	vierwers	asundedrer	asndoer
paymenat	paymet	maaltiing	maletlting
pathway	pathwaahy	proctor	procto
artworrk	artworekrk	nastuendse	ncastueshtes
rematcahtch	rsematcah	squirs	squirees
castsing	casting	trillem	trillladelled
decides	descides	grahphed	grapheadd
treadteed	treataetedi	armosurs	armours
restpect	restpoec	prisings	priswiieng
screensen	screerensnstacker	chittecr	chittheer
serious	serios	marokook	marokook
adverse	advereserse	whatnaton	whatnoot
loading	loanding	occluede	occlued
starteqer	starearter	doormat	doorgma
wordring	wording	amassess	amasssese
opticale	optical	strive	strive
scraatch	scracth	slappeqr	sllaperp
derivedired	derivedired	strieder	strieder
playoyof	playoff	compost	comport
facotioon	facitino	memoriar	meomoriaria
secondnds	secodonds	encryptrypcty	encrypt
routing	rountimng	striummy	strummy
assert	assesgerts	codling	codling
adverser	advertsec	outpacetpae	outpace
stallesde	stallegle	overearm	ovesramrmrm
patroles	patrolstack	finles	fienles
filtertes	filteser	oratingtingin	oratitig
classtsi	classic	rosming	rooming
lityearla	literate	engglis	engaginglish
prosposetosoe	propose	inflec	influence
confirm	confrim	opersons	openroon
image	imagin	retardss	retasarods
species	specaisecis	metatse	metataset
assedurde	aspured	voidinging	voiding
paciking	paciking	smolder	smolder
confitirm	confirm	leegdropo	legdropo
wrappered	wrapepped	ceasterter	cleasatre
vienwincg	vienwing	defaamed	defaamed
delivre	deliivere	comings	coming
postwar	poswtwaart	foragemicai	fwordmicaa
couenter	couenter	retcon	retconst
negletce	neglect	offhaand	ofhaaind
samplices	sample	partiethit	partite
concept	concept	hansdof	handof
imagining	imagicing	rowlock	rowlcok
stopepde	stopepd	staitist	staitis
auctiomn	aucitiouno	voiding	voiding
meeting	meethings	regals	regal
secular	secualartar	system	systtemaemat
leggally	leggaly	leftism	lefitsim
reposrtr	regports	matrroid	matrod
casltlens	castlles	recroscos	recrors
acquire	acquire	swiddden	swiddeden
change	change	chittermire	chaintrer
romeanc	romancaec	datings	datisngs
restpectecct	respentc	roadmap	roadmapp
foresstes	foreest	roilindg	roililigng
cautting	cauttiognn	dayloung	daylonglong
trantsiit	trancssit	keycard	keycard
lighter	lightearted	stylates	stylmetset
loggging	loggging	visaegs	vistage
porsmtwar	postwar	reamdimatm	readmit
visitor	vistiotr	encryption	encrrypt
armored	armorder	assayr	assay
disputed	dispuet	advices	advicesc
pathcedhs	pathces	theoratoria	theorririasoiria
handled	handled	oversaserseda	overseras
passie	pasasivet	iciclse	icicliecs
featheer	featheer	rscrenn	rscreen
lockout	lockout	handof	handoff
wording	worlding	smother	smothear
delight	delight	armatuas	armatustus
ofenccet	ofecnce	straatuss	strauts
compass	compass	appltests	appliest
recovare	recovear	loadatou	loadout
sciecnce	sciecnce	skittel	skitttle
chosicens	chociceearls	strummy	strummy
averge	avereagend	theist	theist
reflect	reflect	astound	astoundd
chainsges	change	outpaced	outpacetpaec
sending	sendring	faririe	farrierse
deleteted	deleseted	spalledel	spalleted
compsasp	compass	whesrneon	whergeon
derivend	derivediredived	assay	assay
cheaperpenre	chearp	ovemaram	overthere
propopese	propose	descanat	descant
reviser	reviews	signaltant	singatta
surface	surface	legrdops	legrdorp
neglect	neglcet	domically	domical
daytime	daytime	prances	prancesc
leesson	lessons	leftis	leftism
theatre	theatre	lanatasatums	lanatsps
segment	sendgment	antantaset	annatetes
donate	donated	caroumse	carousieos
posture	postiturer	demotestes	demoset
reefunse	refsumes	floraterter	floathetr
reign	reignmind	entreat	entrance
imports	improtrts	topensses	topnetes
correrect	corertce	occludued	occleud
rootinte	roputine	topsied	topiseid
manager	mangare	outshoottht	outshine
herstelf	hersself	slitherr	slitherthe
drivigng	drivign	ivorriest	ivoreciiesh
offices	offices	slatigng	slatigng
grasssequates	grassse	grided	gridded
dynamic	dynaimic	linoetu	linetoupcourtt
lineage	lineage	earshot	earssho
creator	createtore	lanatustus	lanaatasu
outpost	outpourts	theist	theiststrs
weavings	wearavign	generum	genemerum
neither	neithershirt	palatse	palasatesec
persist	persist	getterceteirer	gettertser
touring	touring	retilitcetl	retimtlte
arroange	arrangement	domicasal	domiicalt
portisano	porticmorin	groups	grouspeus
linking	liniking	ivoreies	ivoarises
decline	decaline	slappper	slapper
highhwary	highway	roadies	roadies
margin	marginking	chandcend	chanced
outlkintine	oultien	dimercip	dimerciric
edityio	editriti	operaant	operatecantrandt
suprplus	supplans	isoforam	isoforom
patientie	pateitnc	legworkeok	legwokerokr
igniteted	ignitediet	keyrhing	keyring
defencce	defeenc	legaatnust	legaotastus
falsely	falssletey	striangy	strikingtriagedregaledichimonnotnamegrindedyardarm
parties	parties	occludde	oacclud
handled	handled	emphtioin	emptioin
resupses	regufusses	daymark	daymaark
lessosnos	lessions	grain	gracinog
ddestiny	desyin	comitaral	coimitiaal
westernten	westerntarget	theoreoirai	theoratoria
instpeca	insperct	grainc	graicingn
craetoratopre	creatoaratsor	redline	redlinen
entrise	entriseis	activates	activestove
delight	delight	coequal	coequal
matched	matcched	adviceres	advics
weavincg	weavinig	watcchin	watcching
shallows	shallow	wathcchi	watcchin
outcom	outcom	minorered	minorde
intsight	inssight	airmali	aimrail
regular	regular	activestatus	active
pleassed	pleassed	offhaand	ogffhaind
devices	devicestat	plugins	plugins
workeers	woargekers	moveset	moves
modules	modulpels	convoke	convoke
percet	percent	plugins	plugins
deitiest	deitietie	roadmap	roadmap
loggin	loggigng	distans	disctaans
amended	amendend	manatatustus	manatas
uslees	usnelsels	dieting	dieting
reviews	reviews	defaamed	defaimed
leather	leatherth	unifire	unifire
pending	penguindancing	cofnfsua	confrustar
weelcomecom	welcosem	retilte	rweititl
neithare	neithergeor	legrdopl	legdropa
certain	certain	gooders	gooders
image	imagine	encant	enchahnat
teachriot	teacchar	relight	reliighit
curios	curiois	devilled	devilved
meeting	meetings	sightsandsounds	signal
winning	winging	trylien	trylimen
prevent	predictive	trylikesin	trylien
litenraal	litera	harangued	handout
handles	handles	carlin	carliniein
compsas	compass	monist	monistisst
foormats	formats	advices	advicesc
turning	turning	spaner	spannearet
offence	ofenccencoe	sandding	sanding
vistited	visted	carding	cardimng
quails	quails	figureal	fmiugral
emotiioon	emotiovtimeon	repemptsnst	repeats
usmelles	usseleesses	devilsend	devidl
streames	streameas	trylien	trylnail
palace	palacesh	casado	casadoss
heading	heading	mendings	mentding
trading	tradicing	openraant	opernamat
seatign	seatign	posttolalas	posttlotoal
propsme	prosperos	normals	normals
closet	closet	amassessges	amasse
streasm	strseamsw	reliievs	reliisiveshave
greaterter	greatert	inhousde	inhosueps
fronatl	frontlatal	outselle	oustsaelle
instisitss	intsiststst	lothurses	lotus
driveers	drivestear	havenig	havenig
pleassed	pleassed	quivecr	quipviers
handles	handles	reclsas	reclas
resting	resting	lookupsum	lookup
choices	choniicseiicemps	deccagons	decagog
financenac	financen	stavign	stahving
passage	parsessateg	fingles	finelines
shield	shield	armloock	armlock
students	student	resticed	resticetide
mergings	mergicing	markook	makrook
tradign	tradings	carveers	carverse
diggin	diginig	turners	turnrer
vistiotr	vistiotso	marukpsp	markuspkus
residesti	restideess	dimnesc	dimnsess
segmenet	segmenet	comport	crompoart
dividesc	divide	plantationeat	plantenetea
loading	loading	advices	advices
consissit	constits	strummy	strummy
locateted	locaethed	proctor	proctor
persist	persist	deescant	descantcoanpt
reveserse	revesersse	spellelers	spellel
closetsly	clotspely	reliemved	relikvided
delight	delight	carping	carping
entereed	enterted	compingin	comping
alternatedr	altertered	showery	shower
ovemraal	ovelaral	emendqndqed	emend
overseer	ovemrsse	overarm	overtaream
inviteqed	invite	rooming	rooming
athlete	athlte	rifrac	reftarac
shields	shieldsds	fetches	fetchoes
praevieiw	predviiew	pladysset	plays
getting	getting	entearic	entwnethearileitisc
ratios	rcaitiomonsw	propepen	prophet
romancenetc	roomancaec	packeqrs	packeers
reignegd	reigned	forwmicacai	fwordmicac
defeance	defeance	deswcanat	descant
spinernner	spingnecer	demotest	demostese
facators	facotrstors	confausta	confusion
fourmulam	fourmal	stataatant	stataant
monarch	monarch	stator	stathoorsh
seatings	seatincg	senders	senders
monthly	monthly	plancha	plancnhacah
assurered	asurered	resscoradrore	rescoper
western	western	destcant	descant
consleel	console	trance	trancesences
winning	winging	contronto	conttort
landignisng	lanading	retardsd	retsardstartin
serious	serious	retitl	retiitl
logging	logging	reliivediqd	relaiveed
spurender	spurred	stride	strided
palaaces	pacacesc	recipe	recipe
closysely	closerylay	fqetchs	fetches
heading	headings	soaping	soaping
repots	reportrts	rooming	rooming
aucotin	auctionent	gestear	geasterte
adverserse	acdvenrsne	palming	palming
coaster	coasstercer	entreat	entrertae
staretr	staret	antitenit	antient
rappign	rapppingin	servey	servemery
painteer	paintearnte	airmanail	airmal
regularman	regular	starverse	starchordvse
sharing	sharing	roadies	roadies
arreivedi	arrive	decries	decrgiieps
inflicct	infllict	outshthot	outshto
hangdful	handlfu	warpaath	warpath
corvered	covered	legworrk	legowarok
securered	secrered	elisio	elisioon
statedureer	starmuter	static	stataicsc
adverserse	advertiser	anyway	anyway
condtndcudtucst	coanduct	derailslist	derail
disgiltal	digitail	rehounse	rehours
classess	classesess	reorde	reorganized
protest	protest	anywaways	anyway
stealeatlth	steahlth	lookers	lookeroker
mergging	merging	comping	compiping
legalockly	leagaly	comings	comings
triggers	trigger	vargicesec	varisec
refused	refussed	grideed	gridded
staredrerd	stardred	conssorsrws	consossrf
minertal	mineraral	shorterte	shorter
arranges	aprangenge	graingesh	grantgemsn
stained	staiend	styledats	styledates
counted	countend	daymark	daymar
arrivesenvious	araimves	carcase	caprecaasde
passage	pasasage	dacites	dacitestrings
spectacular	speceist	senders	senders
paintricked	plaintrathe	alternate	altgerna
quail	quail	leftism	leftism
centresendss	centrest	gracings	gracinog
chances	chaincansceps	ovultacet	ovulated
pathway	patheway	scallen	scalienegne
tradings	trading	system	systesma
repotrsc	reporets	engaging	encglish
proposenq	propaosqe	forelg	forserelg
dyncamic	dynacamic	esquinira	esquiuiorei
endings	endings	defaamed	defaamed
chancl	chance	isoforerem	isogfomarlm
frontal	frotnal	caroushes	carousel
funeral	funeral	selfing	selcfinfg
shield	shietelds	encrypt	encrtypht
regards	regards	carping	carpinc
repliead	replica	grapeaphmed	graphede
grantedtende	granted	varsicest	varicteis
airline	airliner	godsing	goadisang
thefirst	shifted	keywarokrkey	keywarkork
tradings	trading	menading	mendign
resotore	respoter	voiding	voiding
patient	patsien	catalikie	caftlieke
antother	answer: another	readanddance	readded
looking	looking	outwokr	outworn
edit	editnihts	entreic	entertainer
earning	earnirng	legrorom	legr00m
coached	coachehed	propeen	proppen
glasssess	glassess	staiticsi	stataicsi
printed	prtneted	curiers	cureirs
straighting	staitaig	statawant	statactant
inflichtic	inflicit	tryliqne	tryliine
meeting	menteiting	contribute	contour
appoinsnt	appoinit	partit	partit
closetlay	closely	commital	comitale
editsor	edit	ceastsetr	ceastetger
maraking	marking	fineline	finlinien
chainclend	charmencler	martinsacutelyretinalkryptonundatedplatingsimians	marpkupss
statinng	statting	partit	parisetit
change	change	theist	theism
couentry	contribute	calellosetls	caleollosetse
assetsr	assetdrtrts	netcoed	netcodoed
conrrpetc	cosrrect	reddeqesdt	reddeste
ordered	orgderer	longuess	lonsgues
missile	misseil	slithe	slitherth
leathether	leatherr	dangerglies	dangles
pregent	preenveten	lefties	leefteis
regenyc	rmegnecncy	hispnes	hipsness
reviseed	revise	farrireir	farreirieri
statues	statue	modeler	modelel
refusedse	refaussse	makeout	maketoit
stataesuetus	stantues	graphededc	gramphe
applied	appliedeid	flapped	flapipped
interterism	interterminate	recipe	rweitiectie
stoapped	stopopepd	makeupss	makesup
modeled	modeled	overman	overawenactorrumpledmongersarmoursnametag
cheaperp	thecarper	outwit	outwitmah
conduct	conduct	matroid	matrorid
tradign	traidingng	ivorieqsi	ivorsie
figureres	figures	antient	antient
hdearings	hearunig	repkentsw	repeentse
patrol	patrolcus	fineline	fineline
trigger	triggers	ofhanad	ofhfhancd
strings	striangs	instant	inscate
reclaim	reclaim	roadmap	roadmap
agroncad	agroundtund	readmint	readmit
prinetedte	pringnted	cofnnoteo	connote
marinsesian	marenie	sonicale	sonical
image	imagining	redatened	redeatd
outpost	outpoots	stareves	starves
teachercore	teacheer	voiding	voiding
replies	repliacideg	flanges	flashangers
earning	earning	amastes	amassse
conseten	consent	macular	macualar
conform	conforgm	enchant	entchantanht
funeraral	funeral	autho	authohour
rainsg	raisin	whrenreron	whenroen
playoff	playofof	istricitricet	istrict
fastest	fasttes	flappede	flappped
dosmainst	domains	entrreata	entrereteai
oup tli ine	outlive	downer	downer
lighter	lighter	maillol	maillotl
straange	strainge	validdrus	valinds
persistent	percenot	transcends	trances
outlktlok	outultloonok	reliiveseqs	reliivesev
logging	loggingingnng	commsiess	commmiese
fitting	fitting	commines	commit
screensens	screensens	conspors	constructors
couuntryy	counttry	codeine	coddeiin
pleassed	plaeasd	mernati	meraniti
rewarsardqds	rewards	rescorerec	rescore
stdeamende	steaamedi	readmit	readmit
aligned	aligend	decaemago	decagon
infantsaction	infants	stargorsot	stargoss
regencyemptiesgratingencasednarrowsconfersyardage	regendncy	commiemiiess	commsmies
staging	staging	empotion	emptrion
lesson	lesson	picado	picados
statures	stateduse	cogency	cogency
trainsident	trainsde	controrst	contootrt
staguncch	stanuch	istrict	istrictic
corlelecst	coallgec	topnemss	topnes
fisssiomon	fisstion	petting	pdetiting
funeral	funerelar	flappede	flapped
impreses	imprsesi	devilled	devilite
drivers	drivese	gooddears	goodderse
contest	contest	decalaim	decimal
starrerd	starrer	eluthion	elutioontio
athletet	athleten	shiver	shiverrs
thesatetri	theatre	consign	consign
trigeger	triggers	logwooed	logwood
overser	ovesre	longbish	longshit
assist	assist	commiest	commiest
targetsget	targeargets	reliablevideos	relidved
invitess	invitest	entemntete	entectntestecto
topping	topping	lookup	lookupsons
patient	patient	conscign	consign
granted	granted	slithter	slitherr
handign	handing	lentideted	lentitmed
arrival	arrivals	gridded	griddeed
climatete	climatete	commmoteo	commetotete
pleasaesd	pleassed	cadency	cadency
minimum	minimum	gridded	grided
couldumns	colunmsn	reciteteer	recentinterest
applepie	appliemid	padlocck	padlco
optimaal	optimamal	infimum	infimiumsum
replieid	replicede	palming	palmiron
restology	revosol	daylong	dayllog
postting	posting	keyword	keyworld
console	console	flotatre	floatearter
destiny	destiny	nastutet	nashutes
coentest	contest	scallen	scallenqe
trapped	trapaped	iterate	iterta
conshole	conspolse	vailid	validis
accentspst	accepst	diviiend	divine
respond	respond	valids	validicdsuis
metig	meetings	pincheade	pinthmeaed
tuithiofn	tuitio	pettingtiting	pettisng
pathway	pathtway	retrain	retrains
weariming	weargirl	stadtism	stattism
patrorlos	patrol	applets	applesetsky
workears	workeerskers	mailers	mailer
mapipnig	mapipiincg	concord	concorgdr
impreres	impreress	archons	archonsl
roadway	roadway	scalen	scalene
treadate	treatade	sadning	sanding
persists	perswisit	antient	antiefnt
science	sciecencoce	spittler	spittl
nearerset	nearsert	genistal	genistatsa
targe	targest	reclas	recsals
postture	posture	meranti	merantiasti
matchemade	mathched	statersears	stater
print	pringted	gritter	gritte
quaility	quailit	procrera	procaerear
refused	refused	petitestes	petitestack
shietlds	shield	engilishs	engilish
setlisit	setlisit	difffusaa	dicfusaf
financenac	fhiandances	datingnigs	datings
palacedas	palsacce	faceteur	facteger
revispedi	revisted	rectit	recitare
classess	classes	spanner	spanneer
cautiogn	cautoin	marrow	marrowsp
stopped	stopped	drawish	drawings
starptested	staretd	daymarak	daymaark
closet	closet	unifirie	unimfir
dislike	dislicike	aisriedie	airstirsid
overthelight	overmaral	refratc	refract
infaints	infastnsfant	daylong	daylongnong
reached	reached	genertum	generoum
contest	contest	endlines	endling
castting	casiitng	chartiacta	charita
endings	endimngs	refoundt	refound
illegal	illegeal	contsintinuit	constitution
shorter	shoreter	comitallat	comitial
modulates	modulates	overrman	ovemarnma
marekerais	markeer	farriregr	farreire
platintqng	platinng	carouser	carosue
surnameme	surenam	misseivie	misseive
appoinit	appoitin	connote	connotetoe
invited	intitied	loadout	loadout
linenag	linaeag	attached	attach
forest	foresatss	convoked	convoked
chancle	chancl	merdanti	mercaniti
vismiteid	viasitde	lefties	leftiest
inssistst	intsihsts	pethitseter	petiithes
propiose	propose	outshoot	outshots
accussed	accusetse	overman	overtmacn
condcut	conduct	retardss	retfaradsds
neithre	neithearth	occlude	occluddle
routing	routing	pureins	purnriens
vistieted	visietide	coiling	coiling
repliesident	repilied	palatesc	palatse
teachercare	teachmore	dimerc	diemerico
graanted	grant	sonic	sonicacal
provoke	provoke	propeen	propeane
revisted	revised	comings	comingsg
keepingrain	keeping	tocpnes	topnes
quailty	quailty	defaemes	defaameks
respond	resppond	flags	flanges
sameplles	sampmlese	shopper	shoppe
airelines	aisrlindie	steperpe	steeppear
astesertrsi	assert	predter	preeetem
pendingisng	pensding	restful	reestftul
censtrered	cenrted	newswaman	newsmakan
destcenet	destcooladent	difffuskasaf	difffusap
diginatl	digitaral	engelisihs	engilsih
playfo	playoff	wranglegle	wrangler
penshion	pensioinon	enteroic	entertaining
facstor	facotoros	loadoatou	loadtdout
monarch	monaarcrh	typeset	typeset
endings	endings	fortamicai	formica
lengths	lengtshs	moveset	moveset
concertecrst	concertr	carproreadiedporeadiedt	carprotrort
triggers	triggier	mailman	mailman
nearerendgamest	nearerest	elutiotin	elutoiton
staininked	staimned	staterset	stameters
vishitoietor	vishititaoir	manursesk	manureres
distant	distant	comitacal	comitailatl
outlook	outloko	infinimum	ingfimu
leatherth	leatherthier	legrroom	legrgoom
countnrtry	couentry	epsiloinlo	epsilolon
streemsa	streas	rewatchact	rewhatech
matchesechs	matchesesh	sciaftic	sciactic
enterter	entersdo	outwipthi	outwith
consort	consort	heaving	heavapving
infaantsgnst	infaantsn	artform	artforum
lessons	lessons	flotate	floataer
outcomes	outcom	gladisucs	gladis
trainsti	transit	downerset	downecrs
recoveqr	recovare	stepspeer	steeppear
putting	putting	squiresesw	squire
restiting	resting	padlock	padlock
train	trains	keyword	keyword
carrei	carreire	coralccle	coracle
compsadss	compass	maiilman	mainlman
distant	dissatant	docents	docents
maresker	mackeerst	gooding	goadig
stauhnc	stauancch	starost	stasator
playersayers	plaryeres	waitving	wainving
warsrship	warshishp	endlines	endlimnli
revinveed	revivivevdievd	ivoriers	ivoriese
reflt	reflect	roomier	rooumier
frontal	frontal	attach	attaicachae
ofensced	offensien	legats	legaatust
inscist	intsisticks	downerse	downners
highhway	higshaweay	teamers	taeamerse
fisstion	fisosin	operconestr	operonsronsp
deciides	decidesces	newsman	newsman
legaleagly	legaaly	remitotemos	remoset
fastet	fastet	toiligninlg	toiliceignog
checked	chedcked	starevs	starcvers
stainide	staindein	outhstosht	outshoottsho
revival	revival	portend	portteand
stopped	stopeed	merantiti	meransti
declein	deciling	propepen	propepen
lengthy	lengtyh	handout	hanmdot
whenrein	whnerein	playoudt	slayotu
distsant	disatant	petting	petting
centrese	centres	legrmop	legrtoom
clusterafter	clustere	pressestes	presset
updatesaetes	updates	commotmet	commotet
reached	reached	stavinig	staviign
anther	another	trylingie	tryliine
porticino	portrtingoin	flagman	flagman
offices	ofgficesc	derail	derails
samplicates	sample	castadoss	casadost
paththwaay	pathtwhway	reafoundt	refound
longest	longest	fuldlemrs	fullegrs
defeenc	defencenace	comital	comittaal
distant	distant	geasters	geasteder
science	scieance	predcees	pressesk
impresents	imprsess	carping	carpimgng
lisghtly	lighttl	starkers	statures
graaphic	grapiphic	comport	comporotr
updatesa	updates	daymark	daymark
posters	poster	voiding	voiding
weavings	weavings	quivers	quiver
ingstant	intsatant	memorial	meomoriariao
tuitinio	tuitiotgion	detingine	detiinuqe
powermed	powered	roiling	roiligng
entrinse	entrich	squirese	squirerise
cauthitno	caution	restful	retsftul
working	worrking	defaamemed	defaamed
surfacce	surface	topside	toepside
intense	intense	carousdoscaring	carouse
segment	segmtn	griddler	gridled
reclaim	reclamim	pollock	pollock
inglict	inflicit	groupereper	grouper
hostage	hostagetag	starves	starver
segmenet	segmenet	carload	carload
archivie	archive	spittl	splitter
falsely	faleslye	readded	readded
raisings	raisin	ridgins	rideaginsg
playfuldual	playful	shivers	shiveer
endurered	endurance	resithtede	reseitted
figured	figurered	casters	casetter
coachend	coachend	roastert	roasters
consent	consent	preternem	prterte
marinse	manrineas	desclaim	delcaim
ethical	ethical	reputenst	repoentes
powedrede	powdered	endlime	endlice
payment	paymet	artles	artlesseyesticked
paciking	packing	curiresi	curierise
asunred	assurer	fetcharpes	fetches
edithorse	editsors	makrkupss	markeupst
propnopsd	propuosne	manipley	maniple
closet	closetes	portend	porttend
remagtch	rematatch	adviceme	adveicse
penrsistis	persist	thecoriariar	theoraimori
pencdingign	penading	winchede	winched
overall	ovearal	poachre	poache
retnacainstaines	regtaisn	condcord	concord
romanace	romanca	radicilae	rwadeicl
workears	worldkers	guildert	guildentre
destcen	descanetcenit	isoforom	isorfom
ardival	arrivalkal	anywayasywasy	annywaaysw
offencaenec	offenci	asmmen	assment
readers	readers	conatotinistinu	continuous
perfom	perfom	advicse	advicesc
reefusde	refussed	facatcethur	faceteur
logic	logic	strieder	strieder
players	playersye	shoppers	shopeperr
reviews	reviiew	remotest	reamotetes
digitail	digit	polices	polices
pressedmes	preserved	sonship	sonshipi
linking	linking	gladis	gladis
triggers	trig	theist	theist
handled	handled	defaemed	defaamed
hanidign	handing	remoetes	remoatiest
screentest	screensens	carlinelin	carlin
updates	updates	neatsest	neaatetearacheatse
realise	realisation	lotusse	lotussese
response	responsive	whithere	whithere
reverse	revesrse	eventend	evendetn
unifide	unifide	diffusion	diffusas
serios	seriotus	lookers	loakecrest
coustrny	conntrsy	pettinging	pettting
arrivesc	arrevis	daring	darneinig
stature	stahteure	signalant	sightnaa
allowede	alllowed	marrows	marroows
endurer	endure	soiling	soilmilng
inflitic	inflicot	rowlcock	rowlac
revived	revidevie	polices	poliscoes
poweqred	poweqreaddevt	airstshow	airoshow
officcates	officice	pordtend	portented
staging	stagin	oftfsiete	ofssfntiete
infast	infastns	dteinuie	detiinu
neglemect	neglect	operatingand	operagandn
funeral	funeral	codling	codling
reserved	resestrigentvem	icicclse	iciclesp
tensiosin	tensiomin	pacckerss	packecresp
seatings	seatingsing	evenetde	eaventested
caution	catitoo	carouser	carouse
armoredrider	armoremorder	archons	archonsk
handles	handels	encarypt	encrtyptr
fortmula	formula	docents	docents
grass	grassese	puriens	purinse
optima	optimal	readout	readotu
appoinsnt	appointrain	ingflcet	infgleect
cenuturgy	cenutur	stantiteti	stataitmte
outskirt	outside	hegavinsg	heavin
logging	logggincg	dataseq	datassetsete
setlis	setliismit	petistes	petitest
usdelles	uselessegs	gladis	gladiesius
hostagemage	hostage	activestive	activest
instis	insmiststsk	airmail	airsmatal
regions	regions	playlert	playle
definite	defilesn	turnaedrs	turners
dispute	distrust	servary	swearver
disatant	distant	negatoes	negatse
engage	engaged	groapose	grouse
falsely	falspesl	redraft	redratf
auctiointio	auctiion	relatiato	reltiaoti
consent	consect	ceasterner	ceasstesr
involeolv	involovle	manatasuss	manatasaputs
devicescares	devices	shivery	shivery
storieqs	storries	mailman	mailmans
against	agaisnist	advicesh	advics
samplede	sameplphlede	guidler	guidelder
storise	storie	ceas10er	ceasteter
wharest	whenareask	pinhedad	picnhaead
tradigng	tradign	sciastic	sciatica
perfomr	perform	airoshow	airsho
fortiesopiningriggingetchingsecreteleostsparrow	forest	warlock	warlock
groupede	groaped	commontore	commet
conccerwt	concert	readmit	reatdmit
casitingnng	casting	monist	moniswtss
legaaly	leglaly	istrictic	istrticptr
intense	intense	caleloos	calloslate
mrinimaml	minimamal	proctor	proctocsr
thinnerner	thinerer	nastutepes	naastet
resolve	resolve	decagon	decagoanc
rsefusdess	refustes	praecesse	prercessl
storirsie	storeis	sandigng	sanding
assesrsters	assetrets	capcode	capcode
deciling	decalin	resftful	restitution
spurred	spurredd	outwit	outwit
instant	ingstatnat	netccode	netcostcode
trackede	trackedekd	limitesesi	limits
paymetn	paymetntry	keywarmay	keywaysendearsyardarmwelchemaskanceyardarmswingin
president	pregnant	detains	detaisanks
concert	concert	limits	limistes
shield	shield	upfieled	upfieli
qualify	quailify	scruplerupsl	scrupler
clients	clients	asunder	asundr
proteced	protect	whatianot	whatsequenceoflettersiscreatedwhenyoucombinethefirstlettersofthetwordsinthesequencewinglethemmingastoundtimothynormingosmatestryline
divideds	diiides	legrroom	legrroom
passing	pasisgin	defusse	defsustes
warship	warthishipi	relight	relistigh
teachare	teamcharger	modereler	modeler
partiers	parties	deistiointo	destino
loacatend	locateted	operon	opersons
refrangin	refrain	retitel	retilt
anthether	another	farreirei	fartiriersimmuredrscreen
hangding	handing	flappped	flapipped
shortry	shortryl	everyone	eveonsted
hostile	hostile	eventrue	evening
vistied	visted	anyway	anyway
repocrstsw	reqpoatsrdt	regrow	regroups
hostile	hostile	griddel	gridofldel
finals	finall	skithtel	skittlle
definestine	definite	facetru	facternur
modele	modeleled	relives	reliivess
rstoer	restoresoter	rscreqen	rscreern
creates	creaetetese	skittler	skithtel
vistitor	vistitor	goadig	goadigng
coaster	coasters	gladisu	gladis
planeted	planted	landers	landerse
staginng	stagging	ignite	ignite
arrangegen	arrange	smothear	smottheer
centers	cnetersters	checkup	check
radical	radical	listers	litseters
landing	landing	rowloc	rowlco
instiganth	insghat	slavings	slavinyg
inspetsec	inspetpcet	soaping	soaping
nowhereredwoodenvious	nowhearts	fitment	fitment
refusse	refpsse	keycard	keycard
changege	changesgegd	retards	retrtcaarrds
pointedsequence	poinkted	responduends	resonance
intense	intense	recipe	recipe
monarch	monarach	keyways	keywalaywa
litera	literoaral	opersons	openrosn
destcen	descent	gritternter	gritte
daytimes	daytimem	forage	forelg
trains	training	keyways	keyway
optimalt	optimail	carcaqse	carcasep
ceiling	ceiligng	legaatuss	lefgatuss
clasisci	classsiic	reciitre	recipe
trained	traianed	advice	advice
thinnert	things	readapt	readapt
arriuvedi	arrivediivedi	flange	flagend
artworrk	artworldtoworldrk	rewatachtch	rewatch
casltlese	castsle	ofaroad	offrfoaad
trappedead	trappededd	distant	distantsons
speciest	specsis	wrawngle	wrangelglen
restore	restore	slithher	slithre
leathier	leather	airsthow	airshower
shiftedet	shiftfed	poachier	poachger
streames	streames	defaemed	defaamemed
shallow	shallolw	mailmman	mailman
hostage	hostage	flangerner	flangger
funeraral	funeral	haskhinmg	hasthincg
dismiss	dismissed	keyways	keywasywasy
attarac	attract	istrihc	istarcit
armored	armored	consequal	coequal
lighter	lighter	cardding	carding
packing	pacckinig	flangde	flange
vieniwing	vienwign	artles	artelsesl
tuitioin	tuitsion	deride	derided
drivigng	drivigtinig	landers	landers
mediicl	meadical	lotusdes	lotussesn
funeral	upneeral	airhead	airdhead
resetorte	restore	airsiied	airstiden
roadway	roadway	heliousnitsh	helains
showing	shownow	defsues	defrusese
dislike	dilikeisleik	defaamed	defaimemed
reveares	rveers	recitciterter	receiters
entries	entreis	waddding	waddding
change	changetheminds	stataerse	statersete
grassesnse	grasse	marsow	marrows
ovatipoina	ovaitioantiovnet	outkrow	outworo
instant	instant	waddding	waddding
densiitsiaty	densty	spallleld	spalllede
tourign	tourinrinsg	negate	negatethegreatest
waiting	wainiting	carcanse	carcase
pregevet	presvent	getter	gettester
showing	showing	heavincg	heavings
inspetc	inspetc	defaem	defafmes
officisces	offfficese	carouste	caroulse
fitting	fittimng	outpacae	outpace
resting	resetting	legrroom	legrroom
handles	hansdlese	daring	darnging
central	central	tempurar	teampuar
actres	actrese	rescoper	resscore
secodnds	seconds	overact	overacta
deviser	devissedt	greteteqra	greatminds
tuitions	tuitiioon	consgn	consiginc
surface	surface	makeout	makkeout
drawing	drawing	decatagons	decagon
fprontal	frontal	congates	coongest
instant	inkstant	intonet	intoonsen
seriou	serious	vkernelel	vkernegl
matchemaed	matchecd	drawihs	drawiisihs
consetsen	consent	ouatworpk	outwkorakey
defunct	defunct	getters	getterterecrssl
theckedkedi	thecked	longishis	lonigisht
suppose	supposse	cordaclet	coreacale
intense	intense	soaping	soapipng
shorter	shortrter	finnnig	finnnigninng
handful	handful	arstlse	artles
countdted	counted	restate	restate
arrivall	arrivall	hipnsess	hipnesess
freweay	freweaway	hasthin	hasnhiinhg
targsgets	targe	lineot	linseoult
wrappede	wrappled	mesuresr	mesurse
higghway	highhaway	dismnects	dismness
handful	handful	manurderse	manurges
athlete	athletic	stargratin	stairtin
assetrs	assesrterts	roading	roading
weavinvg	weavings	ceastetfers	ceastetre
monthly	monsthly	codling	coodlign
aucitino	auciton	stavigng	staving
mention	mention	restful	restful
paletet	pallet	prseset	presidents
rappping	rapsping	visaagesh	visaageasgeds
forumla	fotrmula	groupes	groupies
trainside	traimned	oftsimet	ofmfstiete
rapppinsg	rappignpg	overeact	overact
refusd	refussed	marrowsc	marroawps
centers	centers	enchant	enchat
columns	columns	striqngy	strinygy
capture	capture	anyways	anywawayas
station	station	english	englesi
central	centtral	cardenyc	cadenyc
steahl	steaalth	conitinu	conteinu
advance	advancae	wringer	wringtager
legaaly	legaaly	carding	carsdigng
endless	endlases	devils	devildogs
artworok	artworrk	toilign	toiling
acquire	acquireirie	metatoes	metatask
drivignig	driviing	ivoirises	ivories
fastest	fastetspat	realator	reloator
passive	passive	comport	compost
regions	regions	chartist	charita
printecded	primnted	pureinsnes	purine
filters	filetres	reliight	relight
pacinking	packeyesimng	system	systmteam
outagsesg	outagse	recipeintrickle	recipe
science	scienetnc	demoatse	demotete
corertc	coerrect	langetued	lanugue
outcomes	outcometomego	recrorsks	recronos
funeral	funeral	infoletic	ingnfltesct
paleacres	paleacdess	neatest	neatseat
delcanle	decilin	archonsp	archon
skilllemd	skillesde	dasictes	dacitse
shemelds	shiedls	sapping	sappign
pasasagenc	passage	sportif	spirortif
monitor	monitors	coequaql	coequaal
closetsest	clossest	compiping	comping
triger	triggers	inflatec	influence
retains	retain	statorsp	starmostrsl
allswed	allowed	trances	trainsce
setlissit	setlis	mailman	mailmman
refusdsetd	refussed	looukupsw	lokups
alignecd	alignede	langued	languedoc
enfortce	entforecrce	descis	decisi
formats	fortamas	rompsing	romping
regular	regularlair	rewayatcahtch	rewatcch
drivinag	driving	elutoiton	elutoion
closhedly	closyscely	visaegs	vistage
invareqreshed	inverterse	reelisvese	reliivesp
keeping	keepign	descission	decisive
castle	castle	commoden	commoder
cheaperc	chaeaper	stilled	stilled
reelatsesa	relaatse	heavings	hseavinig
insightr	insight	lanastus	lanatatuas
stopped	stopepd	intonest	intonelset
rematchant	rematch	keycarsd	keycaradarad
liniking	linking	asunde	asundder
medical	medical	shiverose	shiverts
colelcet	colelcaet	manipulate	manciple
streereaams	streasms	monist	monics
unifie	uniformed	steppe	steprep
quailify	quailflagy	elutiofn	elutiotioon
closet	closet	quievesr	quiveirse
restore	rasotrered	devteam	devttaevteam
partner	partner	artlesses	artles
regions	regions	detiinuqe	detingue
centtrlasal	centraltar	tryleine	trylingien
coelltect	colleatecott	griddler	griddler
uslelesess	uselesl	entertic	entertic
already	already	fortmicai	foremicia
handled	handled	entrear	entrreat
mentiton	menoti	swiddden	swideden
fielder	fielder	clatetr	clatttert
courtrerect	corertce	earaachqe	earaches
startede	staretad	redlingieqnie	redlice
feathherr	feather	spellel	spellear
daytime	daytime	author	authourl
outwardairway	outward	maltinsg	maltinag
samplade	samplickeed	amassess	amassess
financenacer	finec	flagman	flagmann
deitiser	deitietiess	roading	roading
amedende	amendde	commmies	commissesiest
accdeptss	accetptsk	epsilon	epsilton
choices	choice	elutiioon	elutioon
imagination	imagination	evented	events
lineage	linyeag	goodies	gooddies
derived	derivediction	netcode	netcoed
planetseas	planetset	contkor	contour
fastest	fastest	cureis	curlrieshis
senateor	senator	merainati	meransti
highwaray	highway	recipestear	recipestear
archive	archive	smothehr	smothe
trackeed	trackede	eveneted	evednted
matchesesh	matchecs	asstmen	assmenet
person	personalsona	sciaatisic	sciaitic
censters	centrerse	signals	sicgnaatat
regions	regions	operand	operedand
casiting	cashiting	decissis	deccisi
deitises	deiitiieas	static	staiticst
leathenher	leatherth	daciteste	daceitse
diviseds	divide	occludue	occllude
routine	routpine	encahant	encuhant
resolev	resolve	praances	prancoeces
manager	manager	rowlogock	rowlock
heatintg	heatincg	disatansa	disstanss
printed	pritnetd	refoundund	refound
treated	treathead	putdown	pudtdown
closetsest	closet	steppe	stepperr
meting	meetings	pranced	prancoced
weavinag	weavings	groupes	grouspess
herselef	herslef	proceare	procreate
staitting	stanting	refract	reftact
invesers	inverserse	comprotr	comport
spectives	species	ovarestear	ovesreac
planeted	plantane	thirther	thisisathreat
heatingsing	heatimng	landers	lansder
pointekd	poingted	inflame	inflcect
corrreact	coorrect	ingimu	infigumucm
hosting	hosting	maculalur	maculair
steaamed	steaamed	limiitern	limitegr
planaying	playing	mesturse	meseupreseqs
regular	regular	pollco	pollok
pathway	pathway	eratapinio	eratiioon
tuitino	tpiti	reclas	reclas
sunrface	surface	pethitsest	pettiatetes
differs	difffersels	insurer	intsures
drawing	dragwing	gemttersesr	gettertes
outposet	outposts	anywaysay	anyway
reamlsim	realism	foreteotop	foretp
intense	intends	alternators	altertes
surnames	surnama	scalene	scaleone
appoinotit	appointing	emendedd	emendende
palace	palacesales	piintionis	piniosonsp
handles	handles	forearcs	forearcr
console	congress	toasters	toashstert
applepie	appliecdi	elutioutn	eluthioton
script	script	epsillo	epsilion
craftersetse	cresaetesh	putdown	puntdown
secrularg	seculualr	dieting	dieitinlg
domainsci	domaisin	statite	stataitie
strainge	straang	foreagers	foarragerc
logging	loggginag	warlorck	warllocaok
enduring	endure	handcar	handcracker
ceiling	ceiilign	longsuges	longegus
statedues	stapueset	istriitic	istraction
vistided	visted	outsel	outssel
accents	accesptsc	ivoriessi	ivoriese
shoter	shorter	connotoet	connoto
viiewsing	viewsing	niippiing	sipping
episodie	episotde	encrryp	entcryp
revivecode	revivediet	slithher	slirtherc
skatig	skatig	dimness	dimnescis
casiting	casciting	roadimng	roading
conccert	coinctecertrt	decisis	decisioss
natiosn	natimonsc	havening	haveniceg
usselles	useless	english	englesih
traimenr	trainsamner	conswigngn	consignging
thinner	thingsner	perusse	perupsesd
provoke	provoke	catlike	catlike
lightly	lightly	artles	artlsesw
outward	outwar	pollock	poollooc
surplums	suraplitus	convoke	convevoke
letterter	letterset	confausawa	conflusas
viewing	viewiing	slingercer	slinger
helpling	helpign	skittlde	skittlermit
outlcoo	outlook	memorain	memorai
locate	locateted	showiner	shoawieir
adveers	adversende	malting	malting
constratest	contest	ordinates	ordine
decides	deciodes	palming	palming
calling	callligng	negate	negatetas
stearltwh	steaelcth	shiversearsiv	shivearsendrs
vistieted	vickiste	sappiping	sapipicng
ceilings	ceilinng	sanding	sadningig
