gpt-3.5-turbo_acronym1b_highprob	gpt-3.5-turbo_acronym1b_random	gpt-3.5-turbo_acronym2b_highprob	gpt-3.5-turbo_acronym2b_random
amasiing	wtestnna	atbssuadua	rpdooonfai
miillibars	invcereirin	mncsntfhwypssd	eocntr
hurrry	htlapq	hiee	avst
liainson	saonirh	lndtspac	phtaharaaa
newtorthroonstobns	icaitnap	ntrgnsd	pntdmc
revokem	swaeiorp	rnlpcsr	easbtyav
craetivitiy	acohehloecr	crrbsoilss	mtnafrdgiuai
amtbush	eilmhov	aopmbs	pgrkogss
unahapapyp	oedsttt	hntnmti	sncdtsa
defnesen	sbepeent	tjreia	pawarng
secure	liralet	slyjcs	ytsisvntb
distractederror	iiigrrooenun	vgsnwpct	eopscbocpir
propprivetsrois	nnlgtbsesbas	pbrsbttdssbb	ifodsmnuaer
loan	opnanar	lrgd	nay
revael	ihtiltr	rccrj	cokl
voltagetag	rydvic	vrrtshn	ucaatvppa
postictem	eaeeins	pomps	oatdcaaw
aideed	tide	aiee	eitgry
attendiendanadea	iesisil	ttnnntnntn	rntiigiaeoec
vanish	raispsgl	vslaktag	rpldawatps
hcoly	neer	hsoe	omt
eithert	ebirsl	eotkshdb	yohg
neutraltalraltal	jyotereuf	nemobstesmec	gkntd
intertnetracatc	yberaspaniclni	iieedlascapae	iitnltgiiapn
attempmtpetmed	eecdecst	yggdseosr	aieaom
allyeged	uuaramermaeo	aonrgrbca	hmcrafdsdm
degreres	swordredaued	vpsdred	afrs
icanooegrapahy	areianjenecc	ieaunapmt	uogpcaeciaan
strrtait	nbdaene	tngkld	iernscs
coasstlilein	intiemymot	hnmrsgzls	bafploee
twilightrightrick	isofaeaeedi	tobwlyagta	hegivt
thelapide	sisrrsosopos	drrbunirshad	aonrntnssdsvt
budegerate	ylitestlegu	bopieetacbs	srdaiacsscb
securderextend	talintrickedn	sncedt	aieaee
banish	nreainess	bndnhgdfhsebkdolgs	eptshaeabp
synonyms	eeiriprothurout	sctifibiatu	tacldmbarup
mindset	aptiatlt	mfnestvpg	eagsevcgtg
adaptaatitao	aiepthucto	aajnryuylc	nseclftsmrba
crosings	timesapiepsia	rroaasdi	rtnaonprra
corporal	tnytipdby	crrdncdnnshpznscsfls	ehtsrsbseie
histoarintsaanstr	igbvcsesep	hpestrdwns	yntdaspdh
royanltty	songans	oosnlyfs	nldnrsy
slight	tpoahmmvirr	sldacrs	drtmooehtk
hasitil	onsryil	hrttssbels	oimrse
recnouhnacend	acdrnepnemswr	rgnrtkcoissspti	ivsaoitn
stubb	dne	ssoo	smdt
petrel	cbeyro	pndtsh	ntrgssntr
spat	cyho	sopvs	nfsd
attewends	peirpsp	aetgnsrps	nolnltso
assitiscitnccue	nsgkceerlielil	ayhssdmsr	uadnvngrsctnvrwshdctnohfwy
paaramaonortma	ntdgjragmic	pocwubes	iowmtnslhpm
canas	eaii	rctd	towr
shipperswrecdek	mvrsdtnwaneaonoe	smhntg	oeehnttssr
clones	aeucsy	cldntrc	oetnlyg
rope	otna	eioe	rpslcs
profprietrailor	mgfueerrewut	pdrbtsccp	lrsrtnnksa
urged	defht	uor	tceit
hostpitals	efrearteanat	hovtmtssmg	hpsdhaauy
shophsc	edanc	tshypt	oatd
stlyleyned	rcfraeaa	tssytr	gtnwco
convenientcationsonsw	ialjpmngcnus	cbrileoahua	sdeipdptio
subjecctjeicte	oaptoetel	sbltsoerssfo	iutnrsravm
governservenestern	rculplasely	gshairainatii	eisrtaaaas
camprus	srecenst	cfsps	ggtjnc
triantglease	tannolsoc	toucans	rroaomt
vestsel	stbitemo	vleasb	crrmgs
vietwpoinethems	eltoteqersr	vndvssvssv	aeejdepts
restponse	snrftmossptaa	rpraeacal	lneatooeoc
adorabltel	ehtoagop	aodceocv	focqcrps
pithchse	isevil	pmtwre	yeebts
swims	tmcade	ywnl	eioh
whenelle	ioaradrv	wahd	rccmnhii
shading	rlneyb	sawadecadea	wmdtbsptp
indea	nged	ivdly	eodj
remakearankalbly	itrionkyrrnta	rvgltsgams	rmpgtrsoer
abandondeno	eeessmmii	aftnrsdtrbtrdtrlydtrs	nchswaoadiaaa
batonefrone	lanco	bshb	vndgscg
plaidinttf	rdshavnc	pgrlifssra	rtyjmsfa
harertesc	gnastdlte	heosrteas	aoncstesb
soalr	rarssr	scoarpr	iiee
cinaremicatic	toplstsetec	rgntrcstn	nhjdpoea
projaecets	iaeeiwcdkasi	peacetime	smdwofstara
begin	rrtds	bpli	aetg
popfulatledateld	aoaicdtanoem	pouarpsfsga	rcttstlirrsrtrngstlrcprt
singergexr	sitiach	smlaet	iavtutu
restideex	cardskb	rereiiee	dewcatis
parniking	esscdatet	pcaivaa	iymdeea
trancrsipthai	aooaoymaamzapiicpr	rwdnblmssy	imtltgssararssn
iterartn	hlvarrsprrpsi	ihgsmabu	ehtnfflsg
infsetrtigng	hooegrsi	npsfpea	prrnns
incite	crrdft	iwnlts	ieeas
canndeed	fiougdma	cstnsoe	nayr
famouss	neuveman	frrdss	tgsbts
mole	ptli	yiea	rpsn
sticky	atensks	srtssdf	dgsnol
supereiroisort	iuarasglseairss	smptrrfph	aifvaydwdnpie
pacnage	titrlsln	pascbargr	nrgnsmnfsnscsdcn
inspiringantsirintosan	sacdirrdtsaijstah	iunassfgmaacmncua	rsejctwswvdf
disapponsoit	poonaleaslnit	dphnbtuadisstis	mbszrnygntmstb
pictrickorplia	ghrasiomss	pilatesppb	nhtdcpasrr