bfsrhp	brought force scoring role human part
cnrtutean	continue novel response together unable third ended also north
nolfln	north occurred larger friends left number
atrian	appears term recording immediately actually name
rrveiiyib	records really video ever into issue yard include beginning
shortrhodny	summer houses officials rather traffic received half once designed name young
rchibrt	resulting current helped international building right traditional
artctpad	about result though carried titled possible appearance done
eteslfim	energy tour eight study league full included moving
dlseubidi	died launched some edition under beginning intended directed issued
rarumpi	region again recording upon moved present inside
secefao	surface education city earlier felt area outside
stptaalvrele	supported train provide thought about album line variety raised elements live eight
nrsgdtithgr	nature running sent going divided traditional inside times helped great recorded
grihtpnt	great result inch human they personal number throughout
ecgmiee	elements clear goal morning issues economic education
fatgaty	flight appear things games activity teams yards
cagied	close across giving included elements distance
adbmr	accepted depression better minute radio
eopsera	efforts originally performance series evidence relatively animals
eonsbrlfialta	evidence offered noted successful bridge really listed financial issued average land teams agreed
rdaeusitlarb	right double added entire using singer international trade launched anti received became
talesra	test alongside less education start revealed added
otgaslleecsrr	once traditional goal again section living language ending episodes called single returned return
naertagvre	near access efforts remain that animals gave victory remains eight
minaeoaap	moved immediately numerous attended engine opening actually appear person
otuseitcn	officers they under self elements increase things continued numbers
msicia	mostly starting issued cyclone issues action
folaef	four often listed alongside effect fall
dsiinilscde	different similar issued international near information land second continues director entire
sdce	students defeated castle either
stahlgsim	storm these according hour lived goals scoring issue main
tmenei	trade move enemy notes events issued
ctmueh	court they mostly usually especially hour
srnteaoneypid	significant range novel three edition audience official need earned year problems influenced days
ppenltatno	particularly professional energy national lyrics through available transferred natural operations
mpfcngrisn	move policy face concluded notes gold release idea support need
prooltnna	producer road ordered ordered lost trade novel northern amount
crfcutaen	composed really feature church unable those among election needed
ddvntsrs	directed dropped village north trial space remaining some
sncaeiailen	served needed country almost early influenced agreed included leader either numbers
rcgle	real complete give later evidence
alttlelos	accepted launched title training larger established land overall single
bmilyrlrht	ball musical idea latter yard return lines responsible high traffic
aesectpb	already ended season eventually course teams part being
hclnsitssel	helped centre listed north side initial traffic schools songs effects land
dsneieit	designed soon names engine itself elements inspired things
looenedey	lost others original eventually northern event designed economic years
ohiacuia	operation heavy innings areas called using inches attempt
iteeicniep	involved team effects elected initially court nine includes eventually planned
lalalccaiiucdge	lost along language associated list cover came audience independent inspired using continues dance going eight
saaeoisr	stating appearance additional efforts other increased surface river
eherns	entered health episodes relationship north scored
renctt	real even nearby continues train troops
ionecnngsl	inside often nearby effort concept notes numbers gave scored list
slnvili	seen loss northern victory including league individual
ehtad	every half tons ability debut
uslepcoipa	uses storm legal elements port covered only includes portion attempted
toprepo	three official process remaining episode planned offered
uomudrdaalt	until other material upon dance return design appearance also lines trial
tycsnpase	troops yards create staff needed past ability stars each
bidaeopb	band intended depression across estimated officers poor brought
slsnpl	sought life service national pressure list
aobttbuigoou	audience officer board this thus body using included greater over office used
sesiotrg	such each song island order throughout room groups
eiasrsoe	evidence includes around students right state occurred effort
dodtisoot	depression original design transferred inch several others ordered tried
ielelptl	into especially long economic least period there later
ndlferer	notes declared loss film elected return engine round
unbtpp	ultimately names base then planned performed
fyemolr	forced years effect music others list revealed
calmeh	current action longer mass elected helped
htrptis	home things rating plans thought including style
rrayeesaoal	responsible right around year enough each space addition once appeared largest
trtcnr	tropical remains three coast names river
rcieteiouc	raised completed including economic today each introduced often until contract
drsetrycm	divided runs similar ended turn running yard composed managed
otost	over traffic operations script training
soonoi	society onto opening noted observed inspired
eiogpaiat	each individual office giving party almost issue attempted trial
cscuhnvorc	commercial surface come used hour nearby victory ordered runs combat
ceslmn	call effort smaller love meant notes
aaacieaalil	album added actor conducted issues estimated addition again line industry last
ilnuemtgetedh	increased length need until engine military total guns engine team economic directed human
lonercorieangi	language often numbers ever round competition outside rating inches economic appearance novel giving independent
iscersdr	information structure commented efforts reached schools direct remained
aiyacvh	able inches young annual concept version highest
iocnesenprr	individual others concert names entered short ever needed primary replaced role
doaicsdp	directly occurred another instead castle special deep portion
udoetdee	usually died operation either tour depression early elements
cdeaces	considered done effect available campaign entire start
tiidnitet	their increased initially days number interest train enough that
nryhatis	nature reduced yard hand appointed theme impact standard
frdgrivol	forms result discovered give race initially village officials less
erlnasmii	episode refused letter needed appears start military intended introduced
incrua	involved nearly commander related used across
netfdd	names entered turned forced deep deep
iypfn	interest yard performance federal notes
aens	acting especially numbers sought
euetehr	effort units episodes them entire half recording
