counterparts	cutscene omits undetermined nomads troupes environmentalists returner paramilitaries announcers radicalism typhus spinulosa
iconic	informative consultations osteoderms narrate incubated credence
concentrations	cyber outro naturalism couplet elapsed nebulae testimonies recessive alibi tint infiltrates orientated nymph sentry
consolidated	cinematics outscored naturalism scarf overseer livelihood independents denominational afternoons tremor edicts discounts
poster	profiled opposites scares typhus edicts recessive
depends	decipher encephalopathy protestors escalate naturalism danceable subtype
realism	recur eels adorable laymen intolerable siren macroscopic
operators	outscored pleasantly eater runes appended tearful outscored revamp starve
submit	stair uncensored bathtub misplaced informative tactile
transmitted	tremor robins anonymity nuances stair malice insofar tyrannical thumbs escalate discreetly
demon	dammed epithelium malt overseer nuances
persona	pretense encephalopathy robins suspenseful obsolescent nomads anytime
variants	veterinarian announcers reestablish intrinsically amicable nurseries typhus spectacles
labels	lurid apprehension biofuel erode laymen sonnets
economics	erode corset overseer nematode osteoderms methodical impressively calendars stair
detective	dice erode troupes encephalopathy cairn transplantation infer voiceover epileptic
thirteenth	triumvirate handmade inline replayed transcriptions escalate eminence nuances toddler hibernation
tales	tremor aptly linemen edicts sirens
beaches	barristers escalate aptly cyber hydrolysis epileptic superbly
blame	banal lorries announcers marbled eater
persistent	pompous erode radiate scares infusion serpentine truthful emirate narrate turbofan
steals	scrum tyrannical epithelium anonymity livelihood shortlist
celebrities	classy eminence lurid elves bloodless runes inflected taunts impartial edicts substandard
recall	reprieve emirate consular addictions linemen locusts
economics	eminence channeled overruns nebulae outro marchers interdiction clams storyteller
elementary	environmentalists locusts epithelium mannered emirate narcotics taunts appreciable reload yells
consultant	combatant omits naturalism strippers unfavorably laird tosses appreciable nymph tearful
crossover	carousel runic outro subtype superbly osteoderms voodoo entropy reverb
broadly	brushes remission outscored anaerobic deletion lures yells
conventions	consular overload narrate volt edulis nepotism tactile informative osteoderms narrate sheriffs
depends	diocesan emirate patched eminence nuances distilled substandard
penalties	polymers eminence narcotics aptly leisurely trite inhaled entropy sunfish
comparisons	compliant overruns monolithic pastime accountants recitatives infiltrates steeple opposites natal speculators
orbital	overpasses reload befriend impartial tripped acoustics lorries
maritime	morphs ailment rupees informative troupes impartial macho emirate
stunt	strippers transplantation urbanisation nomads troupes
disturbed	detain interpretive spectacles tactile unsuited rupees bonfire erode disobeyed
renovation	returner entropy natal overload valuables afternoons transcend impairments obsolescent nurseries
poster	promontory outro sincerely transcend elapsed runes
consolidated	curtail outro nosed starve overseer lettered inflamed diploid airspeed testosterone emirate deterred
cluster	countermeasures locusts utensils sentry tripped emirate retainers
unrest	undrafted nuances recur edibility scraped testosterone
spore	storyteller practicable outro recitation eels
unity	undo narrate instilled turbofan yells
prominently	pincer reburied osteoderms mace inline nebulae elapsed nomads transcriptions leisurely yells
anchor	alibi narrate codon housemates obsolescent ribosomal
trout	triumvirate radicalism orbs unsupported tripped
persona	pastime environmentalists retainers solace osteoderms natal admittance
traces	triumvirate reverb aldermen commoner eminence sombre
labels	locusts aldermen burdened entropy labyrinth shoals
frames	fluorescence returner amphitheater malt eater shin
bedroom	battlements eels disrespect reload obsolescent overload macho
inscriptions	impartial nebulae saline cheeses radicalism infer peppers transcend infiltrates omits nematode spinulosa
tournaments	typhus orbs unconditionally racehorse narcotics attest multiples emirate nematode timbre sirens
uniforms	undetermined nomads intricately fireman outro replayed mistrust sheriffs
vampire	voiceover appreciable mistrust patched instilled replayed eels
sealed	subservient encephalopathy aptly lorries elapsed dromaeosaurids
sculptures	storyteller cavern utensils lurid partitions telecommunication undo runic elapsed sunfish
ramp	reverb apprehension motivational porpoises
detect	dentary epithelium tactile encephalopathy chipped tripped
deteriorated	dice erode triumvirate eater readable independents outro rupees ailment testosterone environmentalists disrespect
broader	bronchitis repulsive overseer apprehension docile environmentalists reestablish
devised	detain escalate voiceover interpreters seaboard encephalopathy dammed
orbital	osteoderms runes benched impairments transcend aunts livelihood
dreams	decipher remission entropy adventurers menstrual seaboard
impacted	independents mayhem pastime anomalous cavern typhus edulis defer
recruit	recur entropy cauldron revamp unsuited informants timbre
residences	racehorse erode spicy informative deterred edicts nepotism chicane erode superstitious
entries	entropy nebulae tyrannical ribosomal impressively elapsed strippers
cooler	commoner overruns overpasses landmass emirate recitatives
counts	cheeses orientated unprofitable narrate tosses suspenseful
tends	turbofan entropy nymph dice scares
consoles	corrosive ovaries nomads selfless overseer livelihood epithelium scandium
canon	commoner accentuated nematode opposites nymph
intentions	intolerable nomads thumbs eater nurseries tremor infer outro nomads solves
overtime	ovaries valuables edibility rotavirus tint insofar misconceptions edulis
unpopular	uncontrollable nuances plummeted obsolescent plastics unstoppable landmass accountants reverts
socialist	sirens obsolescent cairn interpretive apprenticed livelihood inertial starch typhus
recipient	remission escalate certiorari impressively pelts impala emirate narcotics typhus
presumed	partitions relays environmentalists spicy uncontrollable moulds edicts deportations
isolation	interpreters subservient overseer landmass appreciable transcendent independents overpasses nurseries
uncertainty	utensils narrate coerced environmentalists relays trite anonymity impairments nurseries transcend yells
recruit	ruinous emirate curtail ravines upload intolerable tint
horns	hobbies overseer repayment nuances sirens
sealed	spectacles edulis amphitheater leisurely eater deified
client	cation lorries impasse entropy nymph taunts
yield	yells inoperable eels lures diocesan
lady	lurid alibi deportations yells
acceptable	anonymity cubeb captivated elves propriety tremor accomplices barristers laymen epithelium
brass	blotches recitatives accountants siren superstitious
discrimination	dice independents sheen compliant relays imperium monarchies interpreters nymph astute testosterone inhaled ovaries nebulae
deficit	distortions epithelium fondly instilled campy insofar truthful
unhappy	unsuited nymph hepatic appraisal penitentiary perforated yells
rituals	restricts incubated testosterone unprofitable astute lurid staffers
unhappy	upload nuances hectic admittance payoff propriety yells
listeners	lures instilled screenshots tripped entropy natal elves ravines spinulosa
testified	testosterone edulis sandbar trite independents furiously instilled epithelium disposable
fore	furiously orientated radicalism encephalopathy
capability	campy annular polynomial accountants bumped infer lymphoma incubated transcendent yells
trenches	tactile replayed emirate nurseries cairn harem eels screamed
