reactor	reply entity aims corn touched observers ruined
happens	harder alumni priests photos enclosed nurse sounded
communicate	conductor operators mechanisms medley unstable nobles investors culminated activated tables erupted
dreams	debts reliable ears accelerated mountainous summoned
stomach	shipyard terrorist operators manufacture associates confrontation happens
roofs	remnant orientation orbits flash spur
everyday	emotion violation enthusiasm rendition yield dominance accumulated yield
halt	hell abbey lord trout
crushed	conductor rituals unpopular soccer hotels ensured dominance
hire	hailed innocent relay elimination
deleted	dedication entity loves electrons torture ears dances
foundations	farmland overtime unstable nucleus demon accepts terrestrial immune overlap narrator silence
concurrent	crossover observe neutron commit unhappy rubber recall entries narrator traces
fitness	flies infant trout nonetheless editors steals summoned
beds	broader endemic differs screened
performer	prose employ referenced formats orbits renovation moderately elementary riots
strain	sounded touched responses activated indirect nobles
moderately	mortar onset determination economics renovation admits trace emissions lunar yield
radioactive	reflection accumulated depends inferior orbital attributes concurrency terrorist implement virtual emissions
recall	relay evacuate chains advertisement labeled listeners
variants	virtual amounted recalls instructor abundance nobles trap saves
sympathetic	specified yield morale punt activist triumph hell enthusiasm telescope installment collectively
shapes	summoned happens affiliated phases entries spirits
trout	thrust reformed orbits unstable traced
similarity	shelters immune meantime iconic larvae accusations ramp invested touched yield
particle	plastic array radioactive transmitted inability concurrent lemur everybody
mechanisms	motivated electrons confronts happens advisory neutron implementation statute melodies supernatural
throat	thermal hotels residences odds afraid telescope
implement	isolation membrane preference labeled emotionally millimeter emotionally nurse terrorist
outfit	overtime uncertainty tears flies informs tornadoes
alter	accurately lord torn entirety reactor
installment	inferior nurse starboard transmitted attributes lunch lectures mathematical erupted neutron thermal
appoint	architects persona publishers outlets inscriptions nonetheless tornadoes
pride	penalties refusal induced deadline evacuate
trout	trap relieve observe unnecessary telescope
frontal	fore reflection odds nerve thirteenth accidents lauded
superstructure	socialist unconscious poets elementary remnant secular terminated ruined unstable confront tired unconscious routed electrons
employ	employ membrane phases loses overlap yield
embassy	elementary motif barrel ancestry sharply shoots yield
anchored	accusations neutron calendar hectares outfit rendition employ divorced
observers	onset beaches satisfied everyday riots valued emissions reopened summoned
particle	purely assured reflection tends indirect conscious lectures economics
persistent	patent enclosed receiver sentiment installment smallest tidal evacuate nerve tiny
criteria	corn recommendation interface transformation economics rendition invested array
mentor	manor emissions nurse thirteenth orientation resume
consultant	corners onset neutron statues uniforms lots terrestrial associations nobles transformation
authored	array unnecessary tournaments hiatus onset reliable enthusiasm demon
orbital	operators riots beta inferior terrorist assured labels
patch	preference ancestors troubled chambers horn
detection	disco everybody telescope entity contemporaries tiny isolation onset nominee
mushrooms	manufacture uniforms supposedly honest rope odds orbits manuscripts saint
confrontation	careers opener nobles fails receiver odds nucleus tiny accommodation tends inter observe nonetheless
shooter	silence humorous orientation observe tidal everyday reservoir
terrorist	tales employ rope rises odds runners invention specified trout
bout	boost overlap unconscious tender
portraits	promptly odds recruit tailed resist accounted implementation tobacco symbolic
muscles	manufacturer uniforms soccer centimetres lauded emotionally shoulders
silence	starboard investors lady enclosed nucleus concurrency editors
demon	drops enthusiasm maternal overtime nucleus
recall	reactor economics commemorate anchored lectures leather
concurrency	conceded odds nurse concurrency unhappy residences reply everyday nucleus catches yield
invested	innocent nerve virtual ensured satisfied trenches everybody divorced
conductor	chaos observe nominee drops unity clever tier orbital realism
barrel	beside aesthetic riots recalls elimination listeners
catches	cream anonymous testified complaint hiatus employ spectrum
departments	deposited economics placement accompany revenues torn mushrooms enthusiasm neutron terrestrial subtle
stomach	socialist thrust onset mount anonymous circulated hailed
maritime	meantime afraid reef impacted trap inferior mountainous emissions
fortune	firmly outlets routed terminated unnecessary nucleus economics
confirm	chaos orbital narrator feat infant responsibilities morale
descriptions	disrupted emissions shoulders celebrations reservoir intercept papal tired impacted onset nominee superstructure
ballet	barrel acute larvae listeners elementary tables
installment	implementation nobles shirts tidal admission loans lady mechanisms ears nonetheless trace
discrimination	discrimination interim sealed cooler riots inferior mouse invested neutron architects thrust indirect observers neutron
sealed	saint everyday amino labels eastbound deity
periodic	peaceful emotionally revenues implement onset disrupted infant collective
climbed	counterparts lauded interface marble blend ears differed
informs	instructor nominee fins overlap routed monsoon saint
poets	parade opener enthusiasm terminated saves
renovation	rubber evacuate neutron observers valued appoint terrible interface opener nerve
reddish	reformed eastbound devised donations installment spur heated
reliable	resemblance endemic labels isolation activist bred leased everybody
reservoir	reporters editors shoots entirety reporters victorious odds interim residences
primitive	performer recall indirect monuments instructor tired intercept varieties enclosed
lots	lord outfit thirteenth statute
plots	pressures locals observe triumph shirts
papal	patent activated pyramid associates listeners
subtle	satisfied unprecedented basement transmitted leased employ
resist	reopened evacuate strain installment specified tornadoes
conscious	constituency operators narrator sharply comparisons iconic orbits uniforms shifts
detect	deity employ torture embassy confront testified
lion	loans induced overlap neutron
amino	automatically mineral intercept nurse observers
employ	enclosed moderately poets leased overtime yield
peaceful	particle entries anchored commemorate entity frontal unnecessary loves
ears	eastbound alumni reunited sitcom
acute	accepts consultant unprecedented tobacco emotion
reopened	rode erupted overlap philosophical elimination nurse electrons displacement
constituency	continuously orbital narrator shipyard tables infant televised unprecedented endemic neutron caps yield
embassy	ensured motif broadly abbey secular steal yield
