national	instructor hate stomach fitness conscious induced calcium climbed
called	acceptable favoured flies blame resume adventures
play	specially cluster fails symbolic
part	spirits hailed trace strain
many	amino tales instances symbolic
ordered	combine proven editors televised pressures persisted adoption
players	spectrum client capability sympathetic descriptions drops associations
city	acceptable discrimination statute sympathetic
process	opener crushed complaint accepts reunited associations isolation
used	burst isotopes medley adoption
music	implementation currents associations hire accumulated
decided	editorial demolition acute limbs odds sentiment advisory
praised	spur troubled lady differs isolation referenced odds
site	associates bishops steals televised
early	mechanisms farmland crushed clinical pyramid
those	statute shortened counterparts isotopes performs
place	specially planted ramp activated beta
remained	preference recommendation embassy manned sitcom indirect reopened additions
late	slopes hailed stunt memoirs
once	lots induced accompany reformed
above	lauded abundance compact overtime servant
third	attributes shed bishops primitive admits
directed	advertisements differently cream reactor iconic attributes persuade advertisement
directed	adventures divisional prone centimetres accusations stretched neutron adoption
outside	counterpart supervision steal isotopes virtual editors recipient
period	spans remnant trenches displacement consolidated adoption
popular	operators nominee specified submit plots calcium trails
southern	associations collective outfit stunt characterised feat promises uncertainty
used	purple associations reopened advisory
section	isolation terrible acute stunt virtual motif ensured
based	observe ears isotopes relay advisory
better	abundance recipient steal statute persona drops
become	abbey recommendation activated pollution implementation membrane
process	spectrum orientation commemorate sculptures peers isolation associates
million	implement bishops alert clause tired conventions unrest
final	affiliated tired enclosed paths elimination
role	transmitted boost elimination democracy
close	schemes blame dome isotopes mechanisms
felt	afraid terrestrial plots stretched
reached	prominently depends calcium iconic shapes reef admission
early	detachment ballot priests blame sympathetic
then	strain shooter terrestrial unrest
never	endemic relay evacuate defender propeller
family	affiliated dancer embassy divisional flies pyramid
lines	aliens filter uniforms referendum isotopes
opened	communicate specially feat instructor renovation advertisement
history	shipyard silence isotopes stomach comparisons frustrated pyramid
parts	spore catches transformation stomach assured
born	observers countryside crossover unconscious
critics	acceptable propeller viral steals miners iconic assured
second	associates persistent acute rode instances admission
made	immune handful adventures perimeter
passed	operators saves isotopes isotopes penalties adventures
population	appoint conceded specially businessman clever maritime stranded disco torture inability
short	associations shapes confront preservation steals
lead	plastic deleted lauded admits
front	afford profitable complement unhappy attributes
told	strictly touched cluster admission
political	spans sophisticated alumni circulated stunt financially accurately farther clever
possible	specially collectively associates isolation fierce abbey planted centimetres
born	abundance tournaments broadcasts unhappy
result	dreams deposited assured businessman placement strictly
established	telescope assured starter captive abundance alter differs isotopes photos receiver admits
instead	limbs unstable isotopes strain merchandise paths editorial
forced	affiliated roofs trace acute develops adoption
previous	appoint broader persona everyday dismissal loses runners associates
victory	evacuate sits schemes stomach possessions creators pyramid
northern	innocent donations orbital statute thirteenth responses breach entirety
lines	clusters tier enthusiasm medley associations
action	radioactive accepts steals silence soccer onset
site	associates visuals stomach depict
third	strain shed bishops prints adventures
failed	afford manor viral alumni reflection additions
played	spans flies halls hyphae remnant editors
version	everybody fever presumably isotopes sits dominance unconscious
once	conscious unnecessary accelerated reacted
field	afford tired realism plots advertisement
version	evacuate detective promises assured dinosaurs companions instances
country	accounted lord superstructure ancestry statute array symbolic
less	cluster lecture isolation isolation
family	affiliated catches emotionally diminished plastic sympathetic
come	activist soccer impacted deficit
year	symbolic deficit calcium prominence
above	caps abundance coaster overtime democracy
play	appoint client patch sympathetic
relationship	trace depends plastic factories stretched limbs loves inscriptions associations chambers tiny spirits
army	favoured promptly embassy symbolic
continued	activists boards ancestors strictly virtual interface nucleus recipient advertisement
claimed	acute flies manufacture pioneer amid senator adoption
troops	attributes presumably nobles possessions appoint associations
month	emotionally mortar ensured strictly thunderstorms
other	loses stunt phases recall promptly
house	philosophical commemorate outlets isotopes seated
sold	associations concurrent placement editorial
death	adventures helium catches starboard shale
control	screened poets unity strain prose corn slope
history	phases dispersed associates steal boost priests symbolic
have	throat ramp overlap periodic
father	afford calcium stranded shipments devastated broadly
video	overtime dinosaurs advertisements declare roofs
