formed	often formed tropical small believed additional
included	different entire action players runs additional period added
story	used storm sound previously system
increased	either only across previous became land used people added
then	station there seven another
period	open members from video home added
early	relationship failed area players system
music	small must established title action
live	also life ever near
received	process behind school better died even team additional
involved	miles entire event moved album over served added
ever	replaced every people areas
list	elements minutes island storm
soon	island does popular under
third	story ship similar present added
continued	action country units stated final under built years additional
served	used felt production over replaced addition
previous	episode created season even time popular human used
stated	used still cast other head addition
free	office previous century people
four	official force full order
outside	four hurricane states island minutes added developed
itself	miles station established behind elements office
said	established national aircraft added
less	place level island island
find	after films into addition
many	small came included system
lines	almost films involved years used
development	addition head event level players points open small better under station
been	about never very announced
studio	established states successful added military southern
half	should each close official
national	announced main still aircraft tour ended career placed
these	other these believed established relationship
return	present replaced itself hurricane critics into
party	episode band tropical still system
different	addition director often after held ordered held increased attempt
caused	scored base turned island left additional
created	across provided relationship have style development addition
event	television every recorded initially studio
state	used others parts states several
parts	appeared called from storm island
characters	scored that same troops various scored story lead production island
these	station there heavy used described
called	action various also class help added
described	additional release island scored troops time above near additional
found	office soon much interest additional
around	rather produced southern built entire added
support	island public open open construction created other
appearance	base episode episode developed based previously father instead across featured
started	established states later area itself near additional
national	involved match state nine command into land almost
several	established felt available century front case players
fourth	office move outside from stated children
continued	across company ended storm million increased turned despite addition
based	above each established least added
than	others them many under
those	others short love established members
force	official local order action least
country	action road successful until others front system
performance	open development produced official sold front small early until across performance
positive	episode sold established find start similar available best
fourth	often considered success area still these
recorded	army served across tour tropical addition section added
ships	used ships film special established
help	there despite placed episode
come	scored forced small heavy
command	scored mother small small race initially additional
open	told opened death interest
that	still shot named attempt
featured	official near late storm full around decided added
sent	island season involved state
tour	started love support from
also	main placed established fourth
command	school located small important earlier until added
often	love official studio sent involved
behind	above held character five instead added
class	school place based island island
critics	scene ordered nine started find school used
soon	used control north include
before	about member after form critics sent
species	used upon head school directed become established
addition	caused addition added lines others million continued included
film	official live club small
political	appearance former class similar states first school same class
find	after films into additional
point	upon month first interest other
time	still films important series
action	early action states history total instead
development	addition believed over featured player tour appearance small described include style
million	important time played album field north entire
heavy	those member late available system
political	appearance does played director stated similar scene father also
little	place director start stated album return
tropical	station created some species list school main players
half	children half player often
such	established full scored they
second	island version school point involved added
forces	official continued army action service established
month	important role include storm than
