nayel	cnolairmeye paaimlr nyscd iesbefltsia ulaurndi
ayuvcaig	lactf oygn rutto svh icsiinich rah oiseerli agnhtsn
aipnliodiia	nadnime aiahnv rprbd pnbamabdsudd uleime uitcer rolss sdletaslt lilnenstitde cisetl fai
neari	anrero aespog laceesp irseetetg nipspiss
aeetlnn	larov heaunosgsiye meidrhs ltsitgl glrtn cnuramupnatop snsisisirat
rcsmsdtrc	rrtyfphltg ycrsnrtry istaneeio amgliiaec ishlrtocieveoo mdtscescc atthrah srlpluaigvei acerce
ltcrnmsutlya	alnoerato ttish ecraidnpa areheonsrs unnptmeiepe umeitvct rslusaf iuhspca ettoetuull iltpe dymsre aaroausrol
ysynd	eymos istspiu tylns enpotraad idrlsrn
dsiiaoau	sdlpcuic ascnmotmi sitau piaeuimeps caocst romsnsaaom lah nuseat
ptlscober	apop otuialllic ils sshoatobe ncbedelpps ioggmaeal cbharaogr oesymnme trsaenyo
eyorgc	eesetra nygln posencad ercoiia sgnmcsd scsto
ottphelf	horti mtmee rtmearg spabauma dhorcol aeubp sleflesm lfdiosl
ygmeofagynh	cylnosfeoni tglen omtr hechtc aocidtme hfobshc iaaneeh lgnicid myoii tnoegi chmreiaisms
noam	tnu sotnna dairp tmaereis
arutteish	tatsee ernents nugash otieil rtmlfta netcsbl iiysrrts isguailin chrmoer
drtnte	edcfian arlgosaratet ateos innlin steilic eeapsit
vbtbsat	cvucat ibavasaeh ntere ubravictrmst lsirsrsyy laaoevel ntieerea
hcirbsaiui	ihyaaaolepba tchasgslirso dii erp bbie lselcatpn oacon oiiritl auhllcisa tin
endhtedd	neenctlt inias udyloi thosrceseana stiio selipeifrm hdsnpau idsnralg
sgsamdtcg	islisinri rgpitbn isatc nae smhesrna adesatvu etnlama ocgobm ignio
annitsin	casrl enhtytsstaaa nnn niileesbu mtumusa tsdgci pirrdpp anildsiehrr
neidisnei	anivredee cense dithlitrarna ndasetd tiosnedssllig isaem mntmrlgrve peeonpt siadmsees
sieo	vsrapr iirfleu eemseend eodaa
aegiea	aatasrmbi pedya igtul dimec aeilinsl iasrl
umriase	dulcoostc imdnyroir mrypvee cingsl caeenh isutiteiadrlbt aecsts
rgesredn	rrshu nggcp leugpdt tsilueyalutieo srlsso dereto rdoadiy mnaiepiio
iftsdlodrieas	oield pfvrtym htvdtpr ssinpbrfeoidoc edysl slrl eotmalcoi hdgtaoln crtccure riiappmn ierioyahgi aatesp gshafeos
ucpceslsaa	but rceapaahsdnr lpys nceisnt aerodaslic ispslt uloih rseeseeulo ear ratcoamia
ceacur	sclief ceeggtnia oarpea eccaa euihnnrirte trte
ohntsa	roeioi phtrsne snogehesru htercld esrddt saeto
eicroid	merones nis ccitp ercaalcbaiof sogiethcas iiiii pdstssh
eneo	leovuscairir nnsiiger eencdrstbc goatnsee
pesned	tpaig aemartni isderieus vncgglet oevr edisnolmn
ilaataptdeoe	giatei ildtbatv canggrtg tayrt stlesrmr cannd speirrl vtbhasemna idagiduee neerrn roismise seeusii
ilaeevedso	siaiinre clrldnini aasfis cesoae uethi tvngeb neiertd adivtosi rsrsags nobedy
ndtiaiat	mnceasngtye adeirmee ltcnamne licuddrtiil nattnmso iihthinlta eassms itnltc
nmhermod	dnmenb dmeig shnoaif ceeigis lrtteim smdpeesit lollev ndfics
tiyoniheot	htmsneo aietrt syadl iodgmstilt anrshprl tigptipfro ehranriae recrvtdrai ioyn ststplge
arehnagis	labdgl srtrlsa eetyutat rhene lnctusdaiosme tavsei egcnl cimli nsatige
emelicolti	resrblaltemrf cmcobagc aeendhenem nlnte eiic rcea dov llsr rtinpee yipe
isih	ditarptrepsi lssvga lii nhpoaedashcn
afdnrvinr	garshyrd afnablb oddeai tnidesostfio sreautre svccautgr iinbgtriy inlulcsn ereroth
osnrhlevd	pofancco nssidi ineooataactd orteoersttur yhcrunrpi clldt beainineis yvtricl edelthl
utrtddr	guruui steol drstra stidus sdceylsn cdyeeete ardbo
rrdnosai	mranee drtts idrddtov enmpecinmo yoee hsrifietv raelgeiyt uiiciga
eaemneish	retmaaaelddc paior getnlcit emsirdia dnurntfctgo reiryp ritsy asmlgchooisten theehao
itsollcgy	biraocsf stcoiy tsnteiu noiddntot dltr llcge dcaeusrn igsanaa iyinni
ecseciteneape	ieonsi eclmoa ssibnirsr depcrliesncea tcomugrr iiysbl dtamtel eenosc enssst setuieeioult ranrad aptithln ceng
nmaeegdsnuh	tnnonanhn dmpterhf sasusrf ceaiirahi detiaso ugrteot rdonuei nstrmgp inrisypnee ruiib thetnif
tlrasmt	ntahmpb dlti uraiaaado aagtal lslst rmieanis utalpegmrr
eopiauil	aenoemm lob epeev nieddp raiutsla sutctnsti eilranbsru dlrvn
raircdrooi	ureaalolclls gatdtiy sincvm arsinmb bcllueasle iditga vrleiiic doa colngoiassh oioiaec
eebisssragl	eeyrceiiynss ieggri cbiiloagc sipuai gsoopeolc hsletcop ssbgindtnvtsaa hriacls paroe lgayhtd slloa
inobitgldgipr	aishrouosi sntbutt uoaein gbhgipeoa yip btbsraoshi egilodi pllc adieit rgsoc einet ipenilid irngpumsostn
eoleeu	regnu foai ulesnstdui sergts ietlbipf iutsorcruar
rrssactinlri	rrelmno srohdie hsaooiscbmtebd lsylnal taananf scsaea nttmns hiiaia pnyucnea dlniipg yrrageso sioggdil
rsaeee	srbppoh iscpc samoc peug lesaigntyi setfodrhl
mser	nmossori msotprnci aeendtployoib iriaboal
lploonerd	ileye hpcarsmi glbai iooctfes cobnirr ongue tee ore odssnn
griaea	lgets irecrgnn iisio aaidsr ienepttsle saoici
esaergcrss	yeep lssty naahllye reirocpyad yrhitob igaipie tcmerp hrdeccio hsinayehh nsnctemasc
etdinah	neohieau itsric edmepnoee rirsrmtt rnpuntyait gatnrier vhfvta
ogiiubueo	gon dgiinea iitur birsodscr euldh abtapil euconsbif dermrsr boncrd
mand	imlesnitf iaomesyfla inaeurhsnc mdpary
eiilartlaelsr	gear niplaedootmt eioasapt hlcnd oadct fricteisrs dtsndnsa eleta lada gerderss slgiicmr ssueasy erfnhteg
rnlsiae	prodsasp tnmiatecs sluul tsfeihtsp tiroo namser ieaes
oanreaafrrab	rocesi tacttcuo cnimeil yrormoa gehhov dados tae dfigtti irfiuerrscve brtin aafoulva tbseathn
yutiletta	eylsreain luegrongeap gtcemis niirvig lli ienn eteglar etrss easmssthatt
tppgeii	ittagi hpoipuor spang mgnsl renmenai yit pirsdga
iunlvmnarv	iinlnn iuachr lntire elfe mveiaaiu smulpmld snaefp haegipc brbarclse evdeonr
tlfntiylr	otmtpye elta tfresid mnoprsnptsls utlsor eioasliat eyfp alnch irtueoas
eglpoll	eeleei egtaras elesdl npbhodege boivrfnseal elui lledle
mmiadpevpgce	emetcsadf smeegsdy hipiu iaeeog odrei nperaivguo leastarn lva dpst egiae ecthusr eeepri
irnrnlsdglg	lifcelu oreleorl tnatisinsggro irnptciohlut entpibhieocu olnctt rsnnngeia odiaie igsce eliercaf ogepeii
ogchetbo	soestgo rgalsso mceplttte ohrouds oedlrnoi ttultnpsnb tbveriri ioeed
ddoah	bdtieua adlciatai nouutsotatf iaslnee ahmntrp
canuvtgnde	nchetcvtsen variin unhttrgrsae ouhrnhfg ovoinaml rtoarre rgsaa yniiaustdiin ederiogde depanicee
toorunursiidr	otaeien sogrmegadic soe iru cuhmoco unsolutyc uurnlseh srmcbae rsltsrhsa ginocarhd lifdr mdedruted aranaved
ddenrbm	tdimeer adnosdtn bedeeule gnaecenm artiali ibitcae imagisl
tgodncotls	btiimain tglgs cona adgtsau enenturot sccgd eoreuecfi etbschslsi iltttaasth nseiensla
eeitlus	tendmb devlaym pisonacss etpsmho olhdria iuerlii astcrseg
ditsftccf	ldihoitoe nieaeias ettho esoslip ufddsor mtonc acoiru ncuundmosgs ifgiatt
ilycprsreb	aioartgh ilbsiedg eytefy ecyeuciaen spnr grsrctpl nsaul nrgasgda seeenerd tbod
lisise	alee niptrt rssidd pilieae gsrffb aeuysrf
aliheca	iaoelt olsel cilhna shadrit deyntolg yctrss caeeei
dnspcsluee	edlerlti tndrmstabat tssneyrct tpapo rcmnsnudo msaloos olussr cucgelo teoeld serlearbtu
ecoiss	sehys gcuehsia uopepaa tiresmcoc dsiln dscleng
riymae	oraoeisssc eilpd lyepn dmrcbec rarcf setvypleir
yoloops	hypoel poch oltt royiandcs tosrge epdoioe usbiopat
pvislgiyyd	epne hvetuynh mismerrn gsitcabes tlsf igfni tiictdai iynffm cydisaoi adscfi
gereooie	mgnlbrt ieral fruiognl eeriin goegtu oodad bilpdiall eelreian
clnieif	acecolnhy plieandlotssr enyoarvt aiuiyrtc teeieo cittlia ifcelgt
lner	tlomts ynsifatnba reetnotto mrpagsnia
bmosurrtegc	hbahrceeh bmayrris socorrp esitipaeoe cuostlfn ordsnnrevl sreosyar itcdv aeoe igiuuaa tcnceoli
mptutnng	imesrbrl spddnclso gtniiuvoei rutdiaitt htenus aneeeitipmu cnsocinsevin igtpu
uhncnonem	muatnhe ehrcumg oniot ecsctei anreiinau sostlolsb tnisnrpsio beilfomcse emrvlaeut
trirnlri	dtfeistnra eradmdtn siist sricoiesu snndao lltpn ersdailsm aioeg
ffiiptre	iftlsna efrsnfc ainsfidesid sioitrnodrol opsht etoscsod frapl sersgooo
hiasai	ehylart dinctr gaham psseri iaspesri eis
rlrlenenn	rrabeauc ultrc arderitn elnoeire segeigeo tntioase redrdcls rnscspecn rneego
