better	obsolescent percussionist standstill stiffened aerobic precedes
their	stun cheapest heartbeat discounts propriety
south	asbestos nomads functionally starch channeled
love	bloodless fondly ovaries menstrual
various	overpasses bassoon broom disposable roast putative usurper
form	afternoons pounded brochure impasse
placed	spinulosa clearances cathode acoustics herbivore addictions
some	astute forays ambience fealty
also	tactile clientele assailants lorries
command	scrum solves eminence impartial banal intrinsically edicts
these	starch thumbs reprimand usurper restricts
state	osteoderms attest valour stratosphere cellars
that	utensils shin paracetamol storyteller
started	usurper stiffened candid prima stratosphere nematode addictions
also	patched floppy osteoderms commoner
reached	prelates repulsive marvelous accountants sheen nepotism addictions
further	afternoons nurseries driest stun thumbs methodical prairies
elements	revamp elves lettered impartial aerobic announcers starve escalate
control	scutes compliant ante attest brochure corrosive aldermen
father	afternoons banal attest cheeses peppers tripped
support	osteoderms lures apprenticed spec rotavirus profane starch
race	transplantation pastime scares hectic
system	usurper hydrostatic escalate starch persistently amiable
official	locusts afternoons affirmation fiasco scarf finesse paddlefish fluorescence
passed	apprehension parchment asbestos asbestos repulsive adapter
further	afternoons submissive protestors utensils cheeses heartbeat arrayed
lost	elapsed voiceover escalate steeple
noted	independents codon starve nebulae edulis
runs	brushes superbly encephalopathy usurper
days	adapter laird hydrolysis asbestos
position	epileptic corrosive assailants diversify starch firecrest nomads inline
local	blotches corset scarf cantilever blooms
army	caravans profiled eminence mycelia
event	reprimand ovaries peppers interpretive stylus
could	scarf volt curveball clientele adapter
continued	accountants monolithic intrinsically stylus discerned unprofitable cutscene persecutions edibility
action	rabbis scares stiffened misconceptions monolithic intolerable
rather	preferential eater strippers chipped veterinarian triumvirate
season	escalate repayment cathode escalate pounded announcers
class	accentuated elves fatale usurper usurper
even	testosterone overload cellars anonymity
lines	plummeted dice annular deadpan escalate
level	flirts replayed overruns leisurely ulcer
told	standstill polynomial alchemy adapter
land	aldermen palatable unsuited adapter
months	amphitheater communicates inconvenient stun shortlist usurper
started	assailants starve sacral truthful stun nepotism edicts
best	obsolescent perforated osteoderms stair
developed	adapter deportations overruns revamp floppy bouncer apprenticed percussionist adventurers
others	postmiles stun phosphorylation selfless orientated assailants
political	aphids counterbalance classy dined stratosphere sincerely screamed masturbation plotlines
used	suspenseful astute detain adventurers
little	bloodless cinematics utensils storyteller slices certiorari
possible	epileptic foramina astute asbestos pincer obsolescent plotlines benched
from	affirmation drifts politely amiable
become	obsolescent debutant screenshots corrective impartial relays
system	astute hydrolysis usurper staffers serpentine amiable
children	scandium chicane dice slander addictions tripped aerobic unsuited
play	spicy clearances sandbar lymphoma
other	bouncer stratosphere channeled pelts fray
court	scraped solves submissive tricolor stylus
included	dined interpreters accomplices bloodless nurseries edulis herbivore edibility
directed	adventurers cinematics credence fealty scholastic storyteller restricts adapter
until	supper inertial storyteller mistrust classy
court	accomplices horticultural cubeb bronchitis stratosphere
career	screenshots caravans transcendent merchantmen testimonies prelates
lines	pleasantly airspeed undo tearful osteoderms
court	accountants foundational outro triumvirate stun
created	accentuated preferably peppers bathrooms storyteller meanders edicts
service	osteoderms reestablish precedes overpasses airspeed scraped recitatives
team	steeple deadpan racehorse omits
line	clientele disassembled uncontrollable fermented
claimed	scares plainly patched fireman impala hemispheres admittance
player	appended classy marchers hydrophobic recessive transplantation
south	escalate bonfire subtypes steeple shortlist
parts	epithelium fatale broom standstill assailants
became	obsolescent tearful scares barefoot eminence lettered
tour	strippers hobbies substandard troupes
under	substandard announcers adorable debutant transcriptions
return	prima heed storyteller subtypes driest unsupported
third	storyteller cheeses fireman predominate adorable
could	scutes bobcat superbly blotches edibility
believed	obsolescent recur placental biomedical readable overseer reindeer edulis
sent	escalate perforated anytime steeple
others	counterbalance stylus cheapest methodical fray osteoderms
month	imperium hoop inhaled standstill sheen
lines	plebiscite fireman inclusions recur astute
city	scholastic distortions standstill lymphoma
ship	assailants thumbs pinnacles speculators
character	accomplices shin campy pretense dammed scraped pterosaur veterinarian precedes
rather	transcriptions hash pterosaur phyla recitatives propriety
local	plotlines solves accountants baboon blur
modern	eminence conceptions adorable reprieve truthful infusion
from	affirmation prep codon omits
times	strippers mistrust emirate reburied astute
became	obsolescent relays scandium danceable imperium aerobic
considered	scandium roast annular osteoderms dissonant edulis aerobic preferably recur edicts
claimed	accomplices flirts hash biofuel omits detain adventurers
every	testimonies overseer meanders craftsman lymphoma
included	discerned unprofitable scandium clientele subtypes adapter hectic addictions
