tocbt	tongues outcrops chemists bloodlines temptation
nmvleida	nymphs mats virtuous lavas entrepreneurs incidentally distantly archery
fsdempmfdhs	fabulous subduction derogatory epicenter mailed posited mucus fouled dismantling hippocampus sarcophagus
sentn	snipers encased nitride tenders neoclassical
estdisb	eradication strangely typhoid defensively interrupts scaffolding booming
enamorcid	endometrial naturalists aspired mayoral overtures reciting carcass incense disobedience
nyaaerossthh	nitride yelling arduous algebraic edifice rufous oven serpin somber tighter hopping humane
enive	educating nymphs incense vacancies encased
leisdlts	lodges ecstatic incidentally scaly disarm lanthanides therapist saturation
syclsesea	subsidence yelling carcass leasing suborder eradication studded enclosures apron
scisod	striving characteristically instructional soda overhears distillation
oeabeaga	overtures embraces amphibian bridging electronically assorted gloomy apron
cinevesgliy	cheerleading intestinal netball enshrined vignettes embodies shrapnel governess laments importation yeah
ousc	ounces unusable shattering constituting
gisfllgtm	greedy instrumentals serpins fluctuating leasing loft glyphs totalitarian microbial
rgnhcn	realistically giraffe neatly hammerhead collateral neatly
osellro	ornament spoil endearing lodges looped recount occupational
invmliarrl	instructional nymphs vehicular materiel lavas imperative archery renaissance remembrance laced
nusuugis	nitride updating superficially unauthorised uphill gradients intellectually schoolteacher
cchdtecmb	claimants cornice hysterical dementia tutelage endometrial cyclic mismanagement billiards
veaohgaf	vacancies embraces abrasive overhears heyday geese appellate felony
rrrsrslte	richness reciting reactionary suborder ruining sectional loot tiling epicenter
tera	tenders educators realist apprehended
orcrrt	opium renaissance computed revising raider tenets
ahdcuio	angst homestead discrepancies cheaply uncompromising inclement offshoot
taooagin	tangible assorted oils onions assuring groupings interconnected neoclassical
elsynrneptoso	epicenter laced slugs yeah nucleotide replenished netball enshrined pearls televisions overhears schism opium
encoberdab	enlargement nightclubs cloning overtures barns enlargement restructured distillation alerts bang
saeiei	superstars adaption eviction imperative entrants irritation
neestn	nightclubs eradication enclosures seamless thallium nymphs
epdiadu	edifice pretended denticles iris apparel deriving unauthorised
ddsi	dissolves defensively superficially instructional
mufiri	minelayer undisputed formulate irrational roar irritation
nttelmiefeel	naturalists tribesmen tutelage eviction liberating metropolis instructional edifice fuses edifice emits logos
ecpuvilace	embraces colliding profitability unborn vehicular ignition lifeless assuring crag enshrined
anenuetf	alderman nitride endometrial nymphs urinary estimation telephoned forcefully
iiipiscy	irritation irritation intimately plunged intestinal suborder contingency yelling
aioasauugs	amplitude intellectually orchard attributing superstars alerts unborn underage glyphs studded
aamdeebot	abnormally attaching mailed dissolves ethereal embodies bluegrass oratory treachery
nmaaiihpsg	neatly modernised ashlar accessing incursion inconsistency homestead petals saturation governess
ersi	encircle roam sprung ionic
spihordtt	speedy plunged intestinal hairstyle overlord reparations dumps tendon tutelage
orinilrai	ours remembrance importation naturalists inconsistency lair retrieving ambushes idealism
ineeiei	interconnected nitride enclosures emphasises intestinal earthly incarceration
ecddancd	earthly constituting dignified demobilisation abolishing neatly cerebellum discrepancies
ritarrbot	roar ideally transporter artistry riches regroup bearings occupational telephoned
rcdrihsti	revisit clubhouse dormitories retreats importation hammerhead servicing tutelage impatient
loaeiellarrei	logos outcrops adventurer ethereal inclement embraces logos lace alderman repaid racer ethereal interconnected
sdeiaidstcn	saliva deserving entrants intimately archeological inactivated dormitories sluice troposphere cheerleader nymphs
nrrtusn	nitride regulator roar treacherous uphill superficially nucleotide
ocepdcis	outcrops clutches enshrined penchant dismantling childish incomes secretion
rnovetranl	resin nightclubs oratory vignettes embodies tutelage reciting asymmetric nucleotide lavas
tlheeiyodin	tortoise leaved helmed embodies embodies incidentally yeah overtures dressage importation nymphs
neygtrlpdmery	nucleotide echelon yeah governess temptation retrieving laced palladium dermal moulded ecstatic refrained yelling
euiitl	ecstatic upholding impatient interconnected triptych loyalists
nsgyduahcots	neoclassical spice gleba yttrium desertion unsettling amplitude hulled commute outburst tyranny servicing
tglney	tenets gradients landscaped netball enshrined yeah
iasl	interplay astatine sprung laced
teyeeeesh	transporter ethereal yttrium encircle enclosures embryonic embodies subduction hips
rsttll	regroup scaly totalitarian tiered launcher liberating
ienycelpsm	infield embryonic netball yeah conglomerate epicenter locates psychedelia scrolls mailed
gdeenpp	gulf dismal encased encroachment neoclassical profitability pretended
toollieed	telephoned operatives ours lavas leasing interruption enshrined eviction divergent
arne	animating reels notched epicenter
ldeenoeigecrr	lingual divergent enlargement earthly nymphs onions emphasises ideally gratification earthly collateral rangefinders redshift
sgrorrd	scramble grassroots recess oriental roam realistically disadvantages
gtigaunrston	governess tenders indigo grassroots anus uncompromising nymphs rhetorical sclerosis tics ounces neoclassical
ttuitfprs	tangible telephoned unauthorised ideologies tragedies fiddle proprietors riches saturation
aenmmgv	alluding edifice nitride maternity myriad greedy virtuous
htaclyrypa	horseshoe tribesmen abbreviation conditioned loft yeah replenished yttrium petals ambushes
nreolnupo	netball rubbing enshrined outburst lodges notched unoccupied piston operatives
esragoa	educators stumbled renaissance accountant gangsters opium abolishing
apsdiraeeida	attendances pearls shrapnel doping intermediary redeem apprehended enclosures ecstatic implements diagrams atmospheres
yelidbonrhg	yeah entrepreneurs liberating instructional dementia blogger ours netball riches hurdles goalie
lndtpilr	leaved neatly dissident telephoned pharaoh ionic logos realisation
dieta	dissolves incline embodies tenders apron
ilmmrdveln	interruption lanthanum mats metropolis reprises dormitories vocally encircle lair neatly
eurrolaeeaiin	eviction urinary renovate repaid overhears laced avalanche eviction educators accordion instructional idealism neoclassical
geuhnvr	gunpoint eviction undiscovered hairstyle neoclassical vehicular ravine
efncfmlsna	enclosures fabrication neatly cedar fairness mainstay lodges solvent nymphs artistry
deeaura	dissolves eviction encircle archeological unusable redshift assemblage
rmotaninp	repaid meta overheard treachery albedo neatly implicitly nucleotide prophetic
naooselchr	nymphs apps observational overdubbed sculptors educating landscaped camouflaged hotter rigs
refyrc	reversible earthly flammable yeah reparations cheaply
dirlbdi	dignified infield refitting lanthanides bearings distillation intimately
nsilailbrg	nucleotide spice imagining ledge animating interrupts leasing basics rainforests gore
tohira	televisions overheard hartebeest incursion reclamation alluding
imtoic	interceptor misuse tutors overhears interplay colliding
eailius	earthly archeological infield lanthanum intellectually unusable splinters
islstgaeiu	interconnected studded lanthanum silently tortoise greedy abridged ethereal imagining ushered
dnmcteaa	dressage neatly mysticism cremation totalitarian enclosures arduous arrogance
nartett	naturalists accordion reciting tryout epicenter triptych tallied
inne	ionic neatly nightclubs emails
pbgoeeiddir	pearls bluegrass grassroots onions echelon enclosures inclement disengaged disengaged iris rangefinders
iiosgaas	inserting interplay overdubbed speedy gangsters asymmetric assemblage surfing
iolanussa	impatient ounces laments assemblage nitride upholding splinters sociologist amputated
rhrlputl	replenished hartebeest refrained loft probing uncompromising troposphere lifeless
riiiongi	riches idealism impatient inserting oppressed neoclassical guaranteeing impatient
yocsgg	yelling outcrops concede subcommittee germanium gloomy
patmoctnn	pines algebraic tragedies milestones orchard coastlines temptation neatly neoclassical
