unpopular	used name positive other present units last able role
diminished	development include million included name instead species held episode days
unpopular	until named place others public units later after rest
hyphae	hours years present hours appeared established
confirm	characters order nine forces include road most
declare	described events career located addition returned event
caution	construction area until than interest other near
narrator	national areas route release appeared times over reached
humorous	hurricane upon mother open role office used small
remnant	received eventually must noted added noted them
valid	very action lead interest developed
dome	days office more events
devised	directed eventually version involved since ended described
presumed	population reached east successful upon most established death
valid	version area lead increased development
contacts	children outside named third about claimed tour said
deity	development each into that year
breast	become race early areas start this
depict	development episode play included critics title
battlecruiser	born added that told lost either children record until included second either reached
medley	made eventually died last elements year
differed	died increased fire free ever reached every despite
dramatically	despite release available many action that island called appearance line lines year
clinical	continued life increased number increased critics area lost
countryside	class often upon named there record years start increased described either
dinosaurs	decided island north only state available upon road same
detective	director events three even career then interest very episode
deficit	death ended forces island continued include they
demon	does each must official noted
inability	included name attempt body involved later increased tropical years
lunch	left used named considered human
tired	team include remained each days
determination	development eventually that even release must increased northern appeared term into over national
prose	period recorded office state either
spectrum	season published each created times reported until months
democracy	director established more open characters relationship announced century year
assured	additional ships such under road ended days
electrons	eventually later entire completed this replaced others nine story
monuments	months ordered never units modern ever number times start
unity	under number involved this years
primitive	process recorded involved match increased they involved very either
cancellation	cast able national chart every less life almost these initially once named
morale	much often role added left either
hell	have every little later
rats	returned across third south
nominee	national open move initially noted entire early
blame	band lead around modern ever
recipient	road early cast instead position include event never troops
cancellation	central able never court ended love lost additional there island official north
prominence	performed reached office must included national ever never came either
satisfied	scored addition those involved support fourth instead elements death
placement	played level areas century event months either nine these
conventions	control opened named video every near those included only noted success
demon	died even minutes others nine
varieties	very areas released important ended title initially each southern
billed	before instead live little entire decided
tournaments	team open under route national addition months events named this service
platoon	play later additional times ordered other near
advisory	around different version included stated other released year
battlecruiser	become announced those time land each court relationship upon initially seven established reached
currents	caused until race remained episode noted their series
fever	final early various event reached
endemic	event near days ended many involved class
declare	died event children last added runs events
viruses	victory itself runs under state even start
unofficial	upon north opened front fire into completed included areas late
lemur	last even many units result
solve	season outside little victory events
slope	still live only provided every
hotels	himself only told earlier line story
buses	both units story even storm
factories	feet aircraft come their once received included each style
soccer	state other command could each remained
locals	live other characters another located ship
firmly	five important replaced much local years
rises	reached into start ever section
manuscripts	minutes another north under species case relationship into positive these should
nominee	north often member initially near entire event
terrible	turned ended rather reached instead born live earlier
complement	considered often most previously least either mother events northern told
screened	studio court record every east near ended different
culminated	club until land modern into national attempt television each does
larvae	least after return version appearance every
routed	rest official upon there ended directed
insect	into named ship even central those
reddish	rather entire director decided initially side heavy
insect	included national species earlier company those
frustrated	feet route until studio team remained another turned events director
philosophical	published hurricane itself life open sound over previously help interest chart able left
isolation	instead special over level about title important order named
disturbed	death involved since troops units result born ever despite
corporation	city often record performance order road almost then instead once never
nurse	never until rest section elements
battlecruiser	base around team term located early created return used island sent events rather
shooter	spent home open outside times eventually release
canon	created album never other never
disrupted	does itself system runs under party television events despite
confrontation	country ordered north formed record often north television attempt total island official nine
cream	continued route east another miles
inter	initially nine tour ever reached
