lavas	lagirouinr applycstetola veodsns aclapdcr soecalhada
materiel	mesrtreai ayenhtuea taydboe eleersoa rerd iecrgrc etlaisnnll lldave
televisions	taotpbysddit eunnteinia lcssogrdun eaiecthls vteeieotu itrtanaveoad sintnri ilcnhieial oslmsnte ncostpg slinehnbrt
cedar	ciede eednssgeal dssavlnictuoa aidutrrc rangilgn
yelling	ylnonlr ercaoeest lnpetcn lioa iolresstmai ntamgy getpiresat
secretion	shorc eplrtiesls ccosmdsn rsieec eaiisics tedshprobsu ieoehao oyee nsmmhelupd
successively	sthftonm utsenornceenrl cdreeprcco cntimupnncg eolanroie siioani spyaarn iitecurdeclte vaclnidne eaclgalhsctyog lala yiro
pines	pitesa ioriinnoi necrlvn eurrcisv sgdticine
fashions	fmsbcnbde asogttpudlaa srnselro hiie iaectslcnreili ooec nmarnnvpruba sberou
pretended	pnaygoslnau rsmtlr eoibytd tfbere eiteaetsm nooeepi dcerhi ellrsra draivrrc
mailed	mirnla aaalymsdg irernelhp lrct eeigrieo dtetainaaln
astatine	asohosc sraouoicrdoel thoaepchedi atrnast trhedepeeo isrprsonemh nnllryaputeo eealccc
materialism	mttotansis acpalsmi taefeatorrhe enmaiceil riui ioitd ausonoottst lgetcors iisolreps srryereni mersns
apps	aiypncet pehtlaac pstnrt seris
imagining	iaailasiicner metimh apraoailndltu gctymydog inetseryey ndnaty ivhterstpi nroale gelmrc
alerts	atcdc ltrrdo eigussigo rdsen tanrser senevgeca
silvery	stbseoi itpeddeiesrm lrforeis vdirueun eatnusur rtinmdtdt ylifueo
centimetre	csnetnheer eesbofu neodeclsmi tltaiiem idaetsr merallentnaee eadticnc tregomp rbrcleenrsi eeyuoolms
redshift	rrlrta erafcrbe diieayin sscpdosm hledep ieca fmmitgtryr tshalnul
modernism	mtatic oaiinre doubm ebcrdnoom rusaposalypis nllytldesnec irisscaytn stlicolloe meaualriit
deriving	diorieeeals elternaoccese rtnnvasmeit irpyairrla vprmiaret imdaesil neuoen gisheu
vacancies	vnatnecb agnsctsrpm clcuise atusaata ntaesut climpoo iutiuidel eoirncr stcrsuomf
dart	dodceseonriis aaicccpoh redyme tpedrin
heyday	hiantn eesnoamesol ystr dieitivrb agthalcduli yageuni
bundles	bisuoldc usgphitoeeaa nnihrr dnpidmata ltngntc etriasyyels stisrdion
suitably	seledb usiiooinctun iscruhnireyeea taetmhnes anmdrseecr bence ltcvrmrn ydca
schoolteacher	snrta cloerutcer hveopiocu ohsmsaarr oeebbeeaa lcler ttevlngsds eetsuohn asineecsp cahcriee hlteietncc eeolttc riedmat
cooperated	ceaiitnraev onteloeta ohsened peecni euueita rdtslocntca avreaschn tnsdaagn eledroemrse ddmarlai
fodder	faurnenr oluesl dmeeistsec didvsngte eacngehnsue rggnabio
neatly	nthlyl eauahet amrlpe tatoetry lefg yshs
ideally	iagivugi daiasiisi eggtnvnhb aoaarebe lncinaddii lrtet yefn
oven	oprtrtha vclcemiyl eoudrsmhaps nneuio
gauges	gtdfcploi aieeseli ucehau ginle endsste sgglailnr
conglomerate	crpunsiaboeidlsias opeobimcae ntavso gtyeirna lohcc oaeieeer meaootuct eltpllor ryshiub alrtd ttnirstpsg ealnttic
modernised	meisieies oietsyhoei daitetnc erighate rrttmomnoe nidveun incidca sbleeiunib esnlcvnd dietvldbtrcl
phrasing	pytaipo hsrttveper rdaeoaee alsdtid ssfere iremnanrie nastpueimtu gsdrhaf
silently	saiglnlnn isnclatslcihll lasdeltin eitoreeuc nnaeti ttaeyhtsuul logdeemlavy yiesann
interrupts	ichagdolsg nnimnn tleoeyea eetydar rprrage rgiits uiarvnartriatl ptiuhliet tteumnol stilmabiia
fractions	fhtcsd rlrcal aiegsrginaive cdmcacc thrlrias iaadhhovaeo oootyesee nsbulp sean
irritation	iipnptlri riaeas rero itgdrnyult tnneti aeauipurr teicoattart isdnsinpormls ottne naomer
dung	desnpsnip uraneegbh nlliuor ggotgivld
overtures	ocesei vrtslncgn einbnvoesea rntesoaseie tesanucns ucslviaa rmrenaplhs erbltain siimeaee
impatient	iateeldnyirpe memohtpl peiree aogserdphpi tatrgit iesiradti euolsntncrn nditan tyrsanhca
manuals	msnfc acatnilns nmlyiagmsicl urpbna aeunoisii lpbeoutir syhcaoisuaall
persists	pgtalto eirisben rudm suelebvednrb iemt sotgicer tosumigu somirade
denticles	dniudidssr elrgedeleeiec nthdtaorye tgecppacmn ieloneuset cptnutg lsoarri eoeeticua sndeonalin
furthered	fdrsu ulotirha rerni ttteesito hosgtsn ennieaesosmu raasrbli ectedsnmnc dliiueaeemsbea
instructional	icroaadlntrura ntlssee sgsarem tnttttt rumensbvuen usinedma caepiida tsebaenne icpanddtnoumt olbtdiyl nsluep aieclanto lroel
interceptor	ieirsehrart nstpnun teabmyr eisiecddahl raydtertrtt cenrhepid eennrcel peserymoo tdeodenpabn ouartrien rlgvrnoeoee
bullied	bopeeeins usaraecimvmsrn lesla llteiterman itolnnsgf evgniyha dicandpsiuc
alluding	asreur loea lnlahniar utlphome doptysrd icgusratg nsftositas gldeeatnan
disengaged	dispin isteaiihrdsss seoootc eigsncdia netcygsrhn grnngt apnnrtbslh glinrmneu enonrsye dsegriioebt
testimonial	teolpl eruunite sditras tterdpay ierevieatmahr mrlrrcs osaeleca nalsya ilbcntaoredn apnaody llnsllmcom
incarceration	iigsnln nrsedrtdints cbnsuteuatba anilaili rrolhlh ctbeadece eefuucleag rcmrctaarhet arsr tsrsrcpo iyaseieivn oenudgede nilsdritonu
cereal	ccnlepo etevsiihl ruehpleeudr erhndrrage aedyseense lnsnd
hierarchical	hlniegfar idinctsnnrld edumgafenl rnllrrnns aanretad regesignsits cceoaml hlmden iodiionom cunltedlg adeseiye liasoae
heyday	hcillsenr eonibecd yaen dllteeyledhi aipiteaeg yuismrc
sync	sdirmg yrliemt nfaactt ciidumseohu
filtering	fatief iettnntal lletl tgpcrc ecniiedi rgceeutos itctenidsfulit ngodionnmd goie
uphill	uensmoee peaes hergiddaa iarpligdt lnyiio lnngc
creatively	cbiennt rlaendceitsea eotsgeas aeteesoycei trnctielao icnahpmdt vtnlmlecd ecanetnies lluir ysom
forging	frress oisy ryatel geusi iidhnaoa ntlmsldceal geblie
flammable	fvslonsg limeott ansaibrase mtss mene acaiistt besfiarn ligg eanaetas
pill	plrnsn intsaaihnarun leltami ltacgueos
subscriptions	sfednoro unliasiese bdee sehdge clamepnpeeet rdrdoiae iurnsdnta prtolr tnhniop isngcrmdte olleee nysngin sitspi
manuals	msebals audloidb nrbremd udpnol asolemle llgeau shmhte
disobedience	diantn imotcit solaeanenre odteidct bgooreheld elsogas dlisiocdi ilcotacelal emnprsgi noineirainis crsa eienselfs
punishing	pomdeeryele uthrfnreld nttnsfb ihaienovpe sreysgoincs hcdionirpa iciua ndctia gcsisoeit
realist	rmehon ethgntic apbssiroet ltnes imlpaltse sodeeepgc tcalsiieas
disengaged	dtrshaoi igvamposse sgrig ercrvcnr ntyviu gmeursbra asieirne geom eeiosono dnsliitnrsl
endearing	ehbtttoi nmmhae dttlnniea enilesp anfell ryrgode ileucyglio nuhlaebrdi gsigmy
tyranny	thldlrtneea yere rrpaeibtaee aediiutsc nirrmtr ntocemi yaepmuh
subsidiaries	sltpyasl uproei bcasecm stetntleud ittclnlnn delnbtlll ilidagtecymn auen rrabtialgem ieriapdonmiere ebeobuit snmeynso
accountable	asuieigo cmvtnellargc calries oubtni uashstl nryiiuyseia thcnpocnnis adeeuyu birfat lseshni ertassc
blasting	bueaiball lnsi arcguneemr srler taeeoopg inspigestbts noosiortss gthvliusr
bloom	bnstrte leuia ooogcpsar oevremesd medp
cooperated	ciedasnao oihesgtrc oilmraiunlpc pplitroccriiv ebrnagfti ruat atdroioyn thyttn eirnsiets dulgee
gratification	guvrah ruro aatnayst tneignoohh inlcaempce fcrintiooya ispdmsnshls ceateiin arcea tslteptel ioatcseroiytr octrerodr nnrpselisohs
orchard	oegsp renaht ccsaiclrlp hnasdfmuac ahaneesci rrorcedeimsi dringeeesimal
retrieving	rsencniy epldhr tasalceo rnlsfilatne ihuyhieea ehgymrs vcpltionl immrutu ncaigi gtlaei
boredom	bteiesia ouis rasbnhublgs evrrnlrne ddlysdide orcepeoeee mpeenrvsi
arrogance	aasucgoio rehntmh rruosortsn oittnrae grnpdrmct ahtgemigpb niluclnnob croeiigauine enlctieic
polymerase	phaidrr oinrleaant lcilp yieodai muvgir enelegevu rnoistesud afaisdg srplreeilneeb eccdsny
forbid	fllsdmrsa oihgsal rilnr badueicsr inomilem deiadraettl
orchard	oeesyts rraear ctetctsrpor hhodusuyoa aaereg rieserre dyrillforl
undisputed	utggiorntoal nsneon daaciresd inrieo seeoivshslh panalrsha uysiondss thagritcutom eidptubi ddlamtdieplp
ulcers	utmsiti liadnterbs ceeredash emsng riaauoai stihtlrtfn
uphill	urnntoe panpithnp hesteal iygioporin lrsag lgcoiis
peerage	pndlnuf eroppgant eheraid ryrihiednmt aiscoetem griiundttaens eallaoatatr
derogatory	dtelinhiongi ecvleaerom roliesit oiergthni gcnnsrtse aanndsseai tersat oensyu rccedmiu yrsv
humanoid	htrlto uitertousnss mceosdhtfs acsto noithonieaer ospenaue iefplriosr derlnotna
forging	fiacrlrbbon oantauvsectrn rtovolade gtsseaets isrgeoasoornri nneayc glteerotin
loot	lpimno oanotgelncue oscstn tdaiopaoti
dormitories	ddynprsrhni onyituei rtvtse mlacatls isidmnoaa tcit oeanbetr riecyncprea iiffn eeeluisni sluclioosspue
childish	ceetcc hrupdiligos ihuemyp lfeerd dsnsviesp inloaooltm sopags hicysslin
upsetting	ucntlinrla pigeira schnrv eatortnh tnohuss truacoyat isuvetaaitegi naygem gneohplsnnie
shrapnel	sugoerryl hyaiyv rtepodg adbedbmcac pyeleullrecli nytatnnnif eroeiiea ltraol
seamless	snioorav etdeusrvrd aepsirencsp mrleipssod ldepa enutdsrh sercieuber saeonns
indigo	iltetleltg nveialy dcyorryue iltienimnnttvm gnoiel oeda
serotonin	seait euiasnti rieaasis octbsenov ttcscl oreyn nphemci iargdac neclelelcerl
