screamed	sealed clinical rituals economics adventures muscles entries dreams
utensils	unrest theoretical everybody nurse sounded inability lauded sealed
solace	shapes operators loves ancestor clinical editors
bronchitis	beaches relay orientation nerve clinical hectares instructor tables invested statues
tasteless	transports amino spans tables ears lesbian elimination sitcom sitcom
returner	rituals evacuate tired unity reply neutron elementary resemblance
unsuited	unity neutron strain unofficial intercept tailed entries desperate
reverb	reopened enclosed visuals eastbound resist broadly
prairies	priests recommendation activated intercept reddish impacted elementary socialist
polymers	polls overtime leased yield manor enclosed rendition steals
menstrual	maritime enclosed narrator starter theoretical responsibilities unpopular afford larvae
elapsed	emissions listeners amounted primitive senator eastbound divisional
parchment	plastic affiliated recall commands hate morale editorial nucleus tailed
rupees	recalls unstable proven ensured eastbound survives
bumped	bitter unnecessary millimeter philosophical employ defender
percussionist	primitive erupted recommendations commands uncertainty sits saint inscriptions opener nerve instructor similarity traces
multiples	mouse unofficial lemur thrust investors philosopher lauded enthusiasm statues
blur	brass labeled unrest recipient
sheriffs	strain hailed ensured responsibilities induced freestyle filter shoots
sulphur	saint uncertainty listeners publishers humour unrest reliable
annular	abbey nonetheless narrator unnecessary lemur associations reactor
lurid	lemur uniforms referendum interim deteriorated
profane	photos rises onset farther associates neutron editorial
pumice	patch uniforms manufacture inter cluster embassy
handmade	halls afraid nerve deficit medley ancestors debated ensured
pelts	pollution editors lecture thermal seasonal
airspeed	architects innocent recipient seated placement editorial evacuate disco
combatant	cancellation orientation melodic ballot additions thirteenth activated nominee tailed
interpretive	immune nonetheless troubled entity recipient preference resemblance enclosed trails implementation vampire elimination
deterred	discrimination employ thermal editorial referendum resist ensured drops
undrafted	uniforms narrator dreams reservoir advertisement freestyle trap enclosed deteriorated
cops	commended operators portraits spore
devolution	dinosaurs entries valued orbits lemur unconscious terrestrial isolation operators nonetheless
humorously	hyphae uncertainty mortality overlap rituals observers unconscious shoulders listeners yield
pumice	pyramid unhappy motivated instances confrontation economics
accomplices	ancestor coronation captive odds marble prose labeled inferior consoles entity starboard
macroscopic	mount afraid coronation rubber operators spectrum celebrations onset performs inter confrontation
sonnets	summoned opener nominee nonetheless emissions thunderstorms shoots
deterred	differed eastbound touched embassy referenced rubber employ democracy
telecommunication	tiny entries lemur electrons conventions operators mountainous mortality unpopular nobles infant client admission tobacco intercept operators nominee
handmade	humorous anchored neutron dome median aesthetic deposited emotion
edulis	emissions devastated unstable lesbian intentions submit
naturalism	nurse acute terrible uncertainty responsibilities accelerated labels inter spirits mathematical
infusion	immune nominee filter unpopular surveys investors orientation nerve
commoner	ceremonial orientation motif motivated observers nerve erupted rubber
uric	unhappy relay innocent calcium
accomplices	associations canon cloth orbits mathematical preference lecture invested caps ears sculptures
astute	aliens shortened terminated unnecessary tears ears
macho	memoirs accommodation cancellation helium overlap
transcendent	touched receiver associates nucleus survives chaos editors nucleus depict erupted nurse thirteenth
laird	listeners appoint infant referendum defender
promontory	periodic reef observers maritime outlets nerve terminated odds runners yield
appreciable	accepts prone poster referenced everybody cancellation invested authored boards lord everybody
blotches	bout lunar overlap trout caps horn emotionally sophisticated
propriety	profitable reef overtime poster roofs instructor eastbound tends yield
profane	prominence rats observe favourable acceptable narrator enthusiasm
affirmation	alter filter farther implement reacted merchandise accommodation testified isotopes onset nominee
asbestos	array screened bishops emissions sued tales opener shoots
truthful	transports reflection unprecedented triumph hardly frontal unnecessary larvae
captivated	coincided alert publishers thunderstorms iconic vacant auction terrorist erupted demon
toddler	thunderstorms orbital doubled dinosaurs limbs eastbound responsibilities
anonymity	appoint nucleus orientation nurse yield mount investors throat yield
decipher	dreams evacuate concentrations investors philosophical hailed erupted reef
storyteller	sympathetic traces observers reservoir yield testified elementary lunch lunar enthusiasm reactor
finesse	freely instances nucleus electrons surveys shelters entries
danceable	dedication advisory nobles criteria erupted accommodation burst lady entity
hibernation	halt innocent bred economics referenced nerve abbey telescope innocent onset nucleus
placental	poets lemur activists corners ears narrator tears amino labeled
biosphere	barrel inability orientation shifts pressures halls emotionally reddish enthusiasm
unfavorably	uniforms nonetheless foundations ancestor valued observe recipient aliens broadly lord yield
hibernation	hectares inferior boiler editorial relieve nonetheless admission tends invested orientation nerve
pastime	prone automatically smallest trails instructor muscles embassy
perceives	platoon evacuate rises caps emotion instances virtual editorial summoned
eels	eastbound enclosed labels steal
broom	beside relieve orbital overtime mechanisms
polynomial	plastic opener larvae yield nucleus operators mere implementation activists lesbian
edulis	enthusiasm differently unofficial lunch instances symbolic
turbofan	traces unofficial recommendation bishops overtime forever architects nerve
dualism	deteriorated unconscious activists locals interim spans membrane
scrum	surveys conscious resemblance unrest morale
uncontrollable	unnecessary nobles colonists outlets nurse torture relieve onset leather lady ancestor bedroom listeners entries
screamed	symbolic coached roofs editors activists moderately erupted dances
starch	subtle terrestrial automatically residences conventions humorous
biosphere	burst installment overtime sits poster hiatus editorial radioactive everybody
phosphorylation	payments horns outfit sends presumed honest operators recipient yield loses authored theoretical impacted opener nucleus
elves	elimination loses viruses emotionally slope
standstill	summoned torture aesthetic nerve descriptions shoulders tournaments inter lots lectures
leisurely	leather employ indirect survives unstable reply editors loses yield
robins	rope orientation binary isotopes narrator sandstone
announcers	ancestry nobles nonetheless outlets unhappy nobles clinical elementary reunited statute
macroscopic	muscles accusations calcium rises orbital seated collector overlap prints instances cluster
intricately	implementation nurse torn reactor innocent captive activated tired ears loans yield
photosphere	parade hire operators tales odds sentiment possess handful everybody reopened ears
tactile	torn amino culminated terrible inability locals entity
benched	ballads ears nucleus crossover honest employ democratic
marvelous	mineral abundance rises virtual eastbound lunch orientation unprecedented seasonal
annular	assured nobles nerve unofficial lunch advisory reliable
bullies	bombarded unstable lemur lectures implement endemic servant
clientele	clusters lunch isolation emotionally nobles thirteenth evacuate listeners enthusiasm
merchantmen	manual economics reef collector honest amounted nucleus thirteenth maternal employ nobles
