unpopular	hurricane included appearance command appeared much played named provided
diminished	additional video small himself interest list used that several additional
unpopular	runs involved opened home opened future claimed caused previously
hyphae	there system appearance children half decided
confirm	across move initially official final present small
declare	additional return across place days created performed
caution	across part built storm side formed increased
narrator	under cast process critics named attempt continued previous
humorous	three music small population previous born further used
remnant	tropical behind important included main announced other
valid	every land players lines additional
dome	additional command small because
devised	addition because event died established second added
presumed	appearance previously became island music important became added
valid	even failed album times addition
contacts	school home under itself party action still island
deity	addition television aircraft states system
breast	about from year called established state
depict	added believed appearance time across station
battlecruiser	about late others start album development school provided full five used seven around
medley	important recorded added claimed believed system
differed	addition list after often second provided heavy addition
dramatically	added provided various important many attempt line action have players elements system
clinical	scene club list into million action failed close
countryside	scene month full only studio process system established life addition reported
dinosaurs	added either increased positive established have full army established
detective	additional period stated period school style side available described
deficit	addition recorded office nine scene life story
demon	added better important considered interest
inability	site only match about title club side attempt system
lunch	class built once scored there
tired	station side present development added
determination	added reached other less tropical important first entire have story miles force announced
prose	upon critics home established central
spectrum	used appeared several scene other previously support small
democracy	addition performed important fourth school ordered career scored system
assured	earlier used used support front members additional
electrons	despite close less action still previous north included established
monuments	small road under further important featured only story used
unity	built include fire storm system
primitive	opened front minutes important title studio time every replaced
cancellation	across rather another action features club almost half storm final month units
morale	important local areas party club feet
hell	character century album elements
rats	present early itself island
nominee	interest told important director announced remained people
blame	able placed each important relationship
recipient	army lead across live appeared line very include storm
cancellation	scored main announced school best also class later station title popular only
prominence	opened created continued small nine initially recorded include scored replaced
satisfied	used each others finished established official list developed added
placement	open class parts scene became important people initially others
conventions	school located entire eventually left interest style site popular until island
demon	addition seven small population units
varieties	over later areas different felt states directed believed established
billed	about since players place best added
tournaments	state position outside around units part small before increased story used
platoon	upon placed late itself some hours only
advisory	battle additional over victory island four provided system
battlecruiser	able band story state claimed release scene critics much field established remained provided
currents	scored outside produced areas result interest style established
fever	after been ever held previously
endemic	despite initially addition help small live school
declare	addition central scene elements part provided better
viruses	even live order successful used relationship established
unofficial	outside increased found official office find scored five family players
lemur	played member important much praised
solve	island sold claimed event death
slope	established elements political species decided
hotels	shot most stated decided placed established
buses	about human used believed island
factories	official each across states moved created live believed established
soccer	used forced scene scene relationship ordered
locals	almost continued across land class used
firmly	often nine tropical small play system
rises	areas video island very established
manuscripts	important name once success island action created aircraft appeared station island
nominee	involved could important military announced release better
terrible	studio decided ordered critics list about players behind
complement	school position important upon elements level small decided include style
screened	established across present rest year instead relationship additional
culminated	across further play small time interest father started returned added
larvae	class particularly present ever later felt
routed	around could future studio death additional
insect	either include established death across others
reddish	process several additional additional video established character
insect	time involved used lead action states
frustrated	often praised further established story front failed others service additional
philosophical	appearance then victory club house island command appeared ship list scored early club
isolation	himself established continued place career started live tour into
disturbed	additional similar island stated such around about features addition
corporation	scored come troops open body area passed states lines both announced
nurse	under full front established decided
battlecruiser	about half others itself almost period action present support video established less from
shooter	established church population hours start decided produced
canon	action based under court involved
disrupted	additional himself established previous published open station head added
confrontation	action love under official production sold initially other party itself miles point units
cream	scene army held passed important
inter	first ended station released production
