tocbt	tiheirm ooupnosi ctlodgce bssetetmsp totnsuaoln
nmvleida	nryeri mmpa vtutisee laste elscnuyyarnyr iivctalrdtsn dsnethhpr asonula
fsdempmfdhs	fuacoson sdleueirou deaociudty epcudatod maumtl pmsicrt mlsgh fnnist daisieolepo hbasirepgap sogburupunc
sentn	sepsole eaedsre niecssa tdsrlri nnncaneictid
estdisb	eyailroynai sdgctennf teniirn daeffndtpro iycalhlspt stumsroeoie bogdivg
enamorcid	eebaiieetti ndrcuevirea aynsarr messars otoaclnee rrmrinse ctspoie idstilo dnscgcudnala
nyaaerossthh	ngeveoa yefmuur adcneui aeoeidofp eiabnru rrigri osgm sielci sprrho ttnltee hbdinin hspgul
enive	eidsncdcp ntmsai ieaceca vnanengeu eysnchs
leisdlts	lhrdei ematoega iantnliponct sedat diatcs lsiunyrciai teyaclsns satlsrathd
syclsesea	slrdsnaeun ycadeba cdlnesn ltorgda sceeotai eceirosoird snrruib eseslgsinp audcu
scisod	souhlrsl ciihtosatitvisnyer iteanrdiaeigs star ornlartac doncltlcivia
oeabeaga	oiyrierci esmorbdh augslpiir bnlecoot eatrtsbylpoomd acrgaenr geaenn avlsm
cinevesgliy	ctrrrnvramia ipeitsento nnrngsh etdisnesa vhsllodbs eotllnpe sneasegi ginhbttai laelone iememhaetee yned
ousc	oaehtg utetsbuu snconseiin clnusttngria
gisfllgtm	gsatnp iuloraeyotagt sltlmas futlerynrre lnsorin leda gafiia tnphsltniscu mbiictige
rgnhcn	rataeecaeleay gtiytll naallm halliefeil chrdarmors nfyaet
osellro	otdgonte sunos eeeinioup ldcgpn lonela ractoir onpmdolcarea
invmliarrl	ietnicancomly neeecs veiresitr mhmhatnr lpisr ieeseavvuc anebema ridulatecsa rrcamayaarp lhrnl
nusuugis	naprfhl ueyipiin sueaerslldelt udhlancieepi uciiri gtusadttl iogrrdtheoaont scltyhuellnac
cchdtecmb	cecetcars cldiiaa htatgcnesl datienlm tuoiiiei eleamalmrel cendno misgaasrlntie bcmrtynmy
veaohgaf	varopenae ecrrvyee aeysmlpi oranbtsee hceshs gliac aaaevaeyd fseleb
rrrsrslte	rsnonrla rahneept rigieybeeca sntonoii rticdgu sgiicunnt lier trsnco eilceoitr
tera	trpsdlp eotaieddd rstcras aeuhenenere
orcrrt	oseem rnsciovtdes capeniua reiintee rsmdan tiurpg
ahdcuio	aoena hencolfel deahgpmomrmto ctryisc uepnsnfasgness imcnchipe odosiitt
taooagin	trlanrcs atdllson otsn ousrei angtuscn geoasobei iidiaecsrosing ncgnliesepno
elsynrneptoso	eheleovtn ltiie senre yiua npvpesilhe rrlaimrhnsc nocndcu eshmhbees palisd tguiestllep ordrlecss seedea oiaen
encoberdab	eiltitdaerb ntiornurus creiegm oannmetlg biegv etesnotltrr rnnrcageulls dnlnsgsetlsc anteah bura
saeiei	ssvitrtort aatttpri eemioasr iacdiseatn enruriae inptpnivon
neestn	nibclmnorl eptmanoimge eelaeyshis scsshlsh tladsuia nrtuuc
epdiadu	esvipid pennirafd danetideh ieuo aceplni drtdeele uicrsirtresg
ddsi	dseiesutl dillfransoe ssiaseucpvcyv iyoiernllftin
mufiri	mriunaaea urpniterto fttdroiro imulontira rayd ilsiaeernl
nttelmiefeel	ntttacrtaui tfsnogies tucenlri eipslsis lsimdbeoeo mrncuetiie iitoaonutsgml eibiier feona evcrtfs eisla ldetg
ecpuvilace	eletiago cisbnsfnc pgtrsnouclegg uiinbo vnrililti iidrshdb llyhness aaioreni cmnf erireraua
anenuetf	aeiraron nrpodhe elmtiemalrt nhdyll ureaefl eemonusdni tristicied fmtyaynpon
iiipiscy	igtlorlnit iinonrrtyn itgarbtldn pileetu idnganorie secotntr cilnieumiyi ynaseta
aioasauugs	aagtardrd iyittutnebullp olcettt aepheondtrr sraesrlunp asahlg ulucde uysnmnie grbled situsrd
aamdeebot	aliaioilua aorbtsamh megtve dybllyeye enocsrae eaglanir bdomcrrea ohrdshs terslestt
nmaaiihpsg	nsrtlg mesrvseerr actect acuneiasi itnonncsi iomeousrlasis hneclaadt pssdno seyeinhytn gaanoseod
ersi	ecunnoai rcpr solcme iginr
spihordtt	sotais pneunpr ieetungdte haatignln ospaedpl ryioetlvemd dydle tlrsoe truansre
orinilrai	ompm raitemnsnyg itrslseraan nbitmhsoaor iitesrenavaun lirb rduinseitm aisceecs iteuolrc
ineeiei	icaeenroynseci ntnirht eadncsolnl eaiseteurc iittteasrl enhnscr itreposdeanim
ecddancd	eishpta clgnomirrhlr doinslebt dgbsaytteflbso adynnieigl nitmoi ceuececena dlesitiuiaiin
ritarrbot	reai irsacua teheergpari acnrsign rtrpes rnecuts biorlldo ooohrteontra tdlplyyape
rcdrihsti	rostoea crpveamne dtlavneipgl rimommtr iocieitthtu hsgetmrdio snreaeeie tsurirus iatteibah
loaeiellarrei	letrs oonhpaco areceleadv emdereee imlegulrp ergacltn luaot lbro ahrsmaac reaete rdesn etdoccne iirnttsenoncer
sdeiaidstcn	sosare dlarnanat etytmeuh igetsmlgin aaeedsniovlri ipctrcalelr deoterherme soyshv ttlrshopcie ccdipeoieii navarn
nrrtusn	nierttg rolllerre reiu tetyaieruop urocoe siihcdaihllap nuasdclfur
ocepdcis	oahrpron cdnimnee elhedeocn pcmiiitt dsncsethisc csanhhsn itiounu ssrglectl
rnovetranl	robii nlmuutteng oarssai vregletli eitcseee tgemntyi rcescdtt auncasehri negsyiovtm lobda
tlheeiyodin	tieeieln ldiyii htmapv eartarpe emeddaes iootusdserrm yvbm oyaomsegt dehlessc ierenntloeb nhoods
neygtrlpdmery	nccarmmhda esvemgp yiae gcvelnddr tloiteecge rlodoelulo lnhrt pditustde dfeaui mteanil enilaeci reraintea ysneole
euiitl	edchtson uacicpcrm ietpnyaoh ittsonecltaprg tidiseny leinitttl
nsgyduahcots	nuirucrilbms sstul gyass yudupvi dlrdlnctm uieacgnape aotntgsut hnnoel cettbnt oeeteiic teemlir sraoylmei
tglney	tedplt gsihensea lnebhiandn nssnele eerdtcatd yraa
iasl	ipnaetila arartpnc sedtgn lyuse
teyeeeesh	tsebmihsnrr erbodibt yulocrs ecerdrte etunruaoop enelaipel eyismmic sncneirutt hcos
rsttll	rdneilr suant tyaoihraarae tionue ltrtabrc ligecielpg
ienycelpsm	iiiolii epyrnanet nasadey ysee cloflireglld ethabslle lortcea pcmdmcclaet sercehb meonon
gdeenpp	geis dmfaae emllctr edtidssoeecr nrlheinfnaat pdtnaailbcyin pocculseo
toollieed	teevpetpns orheritvei onis lrsne lnaioug ideridongnin eseatcren ehtisuvo dpvaltrea
arne	atliinehd rcnpt nsatceg ereonemie
ldeenoeigecrr	ltldynt disrtdolh efayhieaema esnnape nehgal orritn eapfgeiiha iseoals glraceigsyvle ernmlnf cuanlmrhoi retaedntsyln rstirgti
sgrorrd	smgiasbs geaseryano riamov orlrsacd rate rsrstiaealtel dleaocicstsln
gtigaunrston	goscpomon tneerua irocny gcrergsssn apls uirnssllieoeoe ntmavr roaciedcsi siodsuses tsas ocsrlt niosnhhinmcg
ttuitfprs	tnntsioo tlsidoeero udbsrtpeiadl isdrgoecud ttieprien faleoe prleiastien rggdru sahaehohie
aenmmgv	areicurr eyysdif naodnei miiurynge mderle gtidti vtudatil
htaclyrypa	himisidsh taesivhee aiintmrpsoah csteonrufei leel yoth rooeeenrubs yasbtre pnndto amtlbebd
nreolnupo	nrceani rvtdbdd eeteribni ootuingo liegnb nthsedh utbposascl pscnto orspuuuele
esragoa	ehbnicmii ssonnost rnontmltgid ansbeeasda gaucuslee ouara agcutcrpst
apsdiraeeida	agsrenreeed paegim sesmrcso dntila iusprctnohpe riemsd amtrsharepn epeosdeeet entcmaen iciyleedae dnhtntpr aasdrallmps
yelidbonrhg	ynan easpbtegtngor lreusehmrl iochrsieaulir dneodiee bnelrul ouae nerntsb rtisit htaileg garcel
lndtpilr	lsieoi noaedl dslptaesd teheiangcy ptooneh ieaae lavot rnhiidlrnso
dieta	dodvcrsse ioopeii esrsdeen tlsbimn anlen
ilmmrdveln	isinmarreuns lcpotsirl mlca mtoanorsrt rysoerrl dypetinlile vitoare eauiomte lpat nenihc
eurrolaeeaiin	erdiacil uecanuv revlnror rhaets osidavtlt laeoi aooacdvic eemasihs ecrropeee atsnctayd ieancovcnoans icrlciin nudtilnaroai
geuhnvr	glusncei eaaieotl uodaoscevvrs hccpnitii neceisuynvai vniarlone rhdltr
efncfmlsna	eiasoltcnt frrpsyhneil ntrsat carsl fyeuasgs mctnedee liarnm siryvsa nnsyot aeidaoob
deeaura	dsroigmos evceibfb enlelesc aannslveeeehi uacoariu rcstgodc aithslsill
rmotaninp	riyodc macy olvctacmi teidoopdh aellhu nhleti iepeaerblt neapyteere paertdrir
naooselchr	nspnob avtr ootearhaadelp olpfoeaius sadgbrcud egvpeuosn laislddpre cbsindttumt hasyec rgcm
refyrc	reeemralao ebyhema fttenileb yvaa rislhaplyhl cersarp
dirlbdi	drttoetay iehetis reeifllnl lninaiattsa bnsdadig dintiglieiin iinmdgnffi
nsilailbrg	nneuiesdpt sipsn iogtegmcg lecni aaonienrs iirleggiem lasnrat bcstea rotdisairuf gnei
tohira	tvltrnisegl ocnutesei hiarroacte ihmeoenad rsirndbvlil aaesnuoe
imtoic	ieotginyulr mtrreo tnepsh orrltvlsi iespuorni csecdeaat
eailius	eulllny aclsnphrgnlra iiliehd lsnarucoh ineleltauaaait ueylnblt stefeomct
islstgaeiu	iaeyegedegnnao srertcc liaurenbt sesoehhi tetddnyu ggmlis aotndrmr eetiltde ideteldnn uhdrain
dnmcteaa	daerascr nsaeoo mtnusasrs ctegantim trlutrostiuy eiegnroari adcleoc amnaisley
nartett	nirictconci ayhrrylir riraedue tsanit edtnoceat tcelttio tugpslp
inne	iisii numsbc nlcoaeaytt enhllg
pbgoeeiddir	pgrstr bieesansn gnssdrgeno ocssno easaeng eicilsdeaf imrllsins dliegonegu dtoseecrsr inuo raehenagredl
iiosgaas	iseeitisr ialeetbet oyrtpmfggd sdbeba gaplnsiye annrrecegs auvsdyrmem ssnrnug
iolanussa	iseuganom onnpit loceoem asliraptgt ntsnnmp ustplitlt sbmieilae ssiedireeud atgaodchs
rhrlputl	rpaebertaso hcslemirhg rneiinrrp lrne pdeoise ufdtbspefsheoe tlnmnsopgei loifetro
riiiongi	rmaana ierrmaee itgmdantt iuepttcip odssispei nsitoslnigae gpeiacnnncsl ilhereies
yocsgg	yrmcioy olnecinr ceuolce stopdsumoeee glgumobtt gainmm
patmoctnn	pseoa aniaotren tirilierl mtbdoaedss onentcm celssaaeip tclgctssle neearc nthiyiosagal
