national	nerve additions telescope innocent outfit nerve acute labeled
called	careers accommodation lesbian lauded evacuate detect
play	periodic loses advisory yield
part	promises aliens ramp tournaments
many	merchandise advisory neutron yield
ordered	onset recruit deficit everyday referendum entity dome
players	preference loans assured yield everybody referendum schemes
city	centimetres informs tobacco yield
process	placement rituals observe controller enthusiasm solve shirts
used	unstable supernatural ears deposited
music	memoirs unstable shipyard impacted coronation
decided	demon erupted coronation implement detect embassy departments
praised	persuade rode activated intercept steal entity dedication
site	slot inability traces ears
early	elimination authored recalls loans yield
those	trout harder orbital starboard editorial
place	portraits lord afford creators economics
remained	reacted eastbound melodic amounted isotopes nurse entity dismissal
late	loses activated tender everyday
once	overtime nobles calcium everyday
above	affiliated blame observers virtual ensured
third	terrorist hectares indirect renovation disco
directed	devised installment ramp economics cloth tables editors disrupted
directed	devastated induced recruit emotion caps touched endemic disturbed
outside	orientation uniforms tournaments similarity intercept dismissal ears
period	pollution endemic reddish interim orbits dancer
popular	propeller orbits photos uncertainty leather associates recipient
southern	symbolic overlap unnecessary trout hardly emotionally renovation nominee
used	uncertainty starter enthusiasm dedication
section	symbolic enthusiasm contemporaries thrust insect orbital nobles
based	businessman adventures sharply enthusiasm depends
better	bred emotion touched trout endemic receiver
become	boiler elementary criteria opener medley editors
process	proud receiver orbital cure ensured steals spans
million	mathematical intentions limbs limbs implement overlap narrator
final	freed invention nurse appoint limbs
role	routed orbital lesbian editorial
close	counterparts lectures orbital spectrum economics
felt	farther erupted lesbian tables
reached	recreational editors accurately correctly hardly emotion depict
early	everybody afford realism lord yield
then	trace hell everyday nurse
never	nerve emissions victorious embassy rises
family	freed advertisements mortality informs loses yield
lines	loves isotopes nurse everyday slopes
opened	outlets pinned employ neutron entirety deer
history	hate innocent spore tender operators responses yield
parts	possessions anonymous reply thunderstorms spans
born	bitter outfit recreational nurse
critics	conventions reddish indirect trap implementation circulated sculptures
second	supervision elimination chaos opener nurse dancer
made	muscles accurately dreams economics
passed	primitive acceptable secular sophisticated entries debts
population	pinned operators purely unity limbs accompany throat inferior observe nonetheless
short	submit helium overlap remnant thrust
lead	lord embassy admits dispersed
front	farmland ramp opener nerve terminated
told	trenches odds loses doubled
political	promptly odds lunch induced terrestrial instances counted auction labels
possible	pyramid observe secular saves indirect brass lunch elimination
born	beaches overlap roofs nominee
result	reliable erupted starboard uniforms larvae trace
established	entity schemes tends array beta lots inscriptions supernatural horns ensured devastated
instead	infant narrator screened transformation everybody automatically dreams
forced	freestyle orbits routed continuation everyday depict
previous	possessions resemblance everyday victorious iconic operators uniforms sitcom
victory	viruses inscriptions careers tables outlets realism yield
northern	nominee outfit rubber tidal hardly enthusiasm recruit nonetheless
lines	loves impacted nurse elementary sophisticated
action	aesthetic conventions trace implement odds nerve
site	soccer isolation torn entity
third	terrible hate inscriptions rats detect
failed	fore appoint innocent lion entity differed
played	performer labeled abbey yield entries detect
version	victorious enclosed resist sandstone inscriptions opener neutron
once	observe nominee concentrations elementary
field	freed invention emotion leather diesel
version	viruses emissions remnant surveys induced overlap nonetheless
country	correspondence overlap unity neutron tidal rubber yield
less	lectures employ suburbs sounded
family	fraud accusations maritime inter leather yield
come	continuation onset mentor employ
year	yield entirety afford renovation
above	accurately bitter operators visuals enclosed
play	possess labeled automatically yield
relationship	realism enthusiasm lemur authored tends instructor outlets nobles sealed helium interim preservation
army	array responses mineral yield
continued	collector odds nobles transmitted inability nerve unprecedented ensured demon
claimed	ceremonial labeled attributes intercept manual endemic determination
troops	thirteenth rubber overlap overtime practiced saves
month	monsoon opener nominee tends hire
other	observers tiny hardly employ referendum
house	horns overtime unstable sided eastbound
sold	scripts outlets leather disturbed
death	deer entirety alter traces hardly
control	coaster opener nucleus touched riots onset listeners
history	halt impacted satisfied trace orbits referendum yield
have	hell automatically violation enthusiasm
father	flies accumulated thrust honest elimination rode
video	viruses investors displacement economics orbital
