gvch	agreements avoiding activists thermal
reehy	trenches periodic defender characterised tying
erenen	celebrations graduation hectares entries reflection ensured
imlfimttct	filling amid client offspring yield amino attributes starter sculptures stunt
inmrtetds	fitness ancestry amino fraud statues defining stunt editorial associates
busrhh	observers hung isotopes dreams ghost shirts
scettitlrl	associations accommodation depends starter steal discovering stranded aliens pride clinical
cgtmdos	iconic agreements statute imagination advertisement confront issuing
lcfeog	cluster activists affiliated defining controller agreements
etoceiteeor	reliable stomach portraits occupying responses limbs steals reddish nerve consultant graduation
daibioteu	additions basement sided abbey dinosaurs monuments stranded recovering ruined
dslhsgrog	adventures isolation plastic chaos issuing agreements freestyle poster agreements
leineac	clause designing differently insect democratic ears accusations
nmgbbbcns	anonymous immune agreements observe observing abbey accumulated integration assured
oodsbppeebb	rode counted advertisements issuing observe opener opener feat mentor abbey observers
aimdtudtche	passages diesel emerge advertisements stopping fungi advertisements strain activated shifts resembling
ocrtitlduul	boarding acute propeller steering similarity steering client advisory lung businessman slope
omutrers	homage amino purchasing stopping brass seasonal preference isotopes
ssrdeaibu	isolation assured frames adoption testified caution binary abbey superstructure
ngresteut	unconscious agreements presumably seated issuing starboard reunited punt stunt
aeropnbtt	caution reservoir freed boiler appoint infant abbey stranded starboard
scttlrvn	isolation schemes steal starter clusters orbits averages interim
tseaeooa	stranded issuing merchandise particle fever concluding sophisticated halt
irisnyngea	discharge dragon siblings issuing integral symbolic enclosed agreements sends fantastic
sgrassel	associates agreements troubled labeled assured issuing recommendations plumage
esrhtsac	deer assured transmitted ghost statute issuing happens sculptures
nsotma	onset associates concentrations stealing implementation vacant
elimictdlbsel	declare altogether dinosaurs imagination displacement accumulated starboard advisory alter abundance associates mentor alumni
dscaysem	editorial isolation activist paths sympathetic isotopes recalls imagination
uenddprnspne	supervision beds entirety adventures advertisements operators freestyle incorporating isolation spectrum endangered demolition
clpeegr	accumulated alumni spirits democratic terminated agreements presumably
lrndeeae	alert priests anonymous admission reliable secular manufacturer reef
eipe	genius discrimination specially depictions
lttsta	cluster steal stomach associations statute eastbound
tiet	steals fierce medley stopping
ceessum	accumulated fever referendum associates isotopes purely amounted
sedmopup	isolation recreational adventures immune consoles opener outlets specially
eiiractonirle	terrible differently binding drops cancellation activist starboard gospel instructor aims dramatically alter descriptions
ideteyd	biology adoption centimetres strain refusal sympathetic editors
ieaiig	mineral devised fault tired dispersed agreements
nmnhdcrlre	incorporating emissions antagonist chains additions accounting freestyle slope troubled servant
essedtanasav	perimeter isotopes associations rectangular adoption steal manual unnecessary maternal associates halt overtime
seruu	associations servant brass submit muscles
icopiuartin	limbs schemes commit spans circulated buying harder trenches stunt mineral unnecessary
sleaodesope	assured aliens membrane dances portraying odds reflecting isolation conning spreading tears
uemduyaahl	burst recalls amounted admission submit tying lauded saves theoretical client
csnfhm	occupying isotopes instances offspring theoretical emerge
bsbnceen	abbey isotopes observing onset accelerated celebrations heights ensured
ypmnoebtr	hyphae specially implement unrest dominance deer obtaining strain breathing
ngregsnla	instructor agreements prominently beaches agreements isolation ancestors electrons barrel
hittoeiem	ghost bishops stretched steals loans resemblance eighteenth genius amino
tolcedivveta	strictly soccer altogether accounting sentiment advisory violation avoiding evacuate mentor stopping ballot
ovheecu	posthumously averages thirteenth melodies reddish accumulated hung
rtisti	propeller strictly dissipating issuing strictly gills
iniarrrclp	dissipating undergo miners fails propeller broadcasting broadcasts screened clinical spirits
errlee	deer freely irregular plots resemblance telescope
ittiesns	timing stranded starter visuals lemur isolation invested associations
vastipco	avoiding larvae associates stomach victorious spectrum sculptures commit
eciiillooep	designing accompany dissipating violation diagnosis elimination clause donations possessions technologies operators
ehedlooltc	performs shapes deposited advertisements blend congressional collector clinical steals activist
tceegpro	statues activists bedroom reunited agreements spur breast sophisticated
ossaasc	comedian associates associates halt mathematical issuing accelerated
uerodaat	authored recruit creators moderately adoption happens hailed stealing
neesetulsu	intercept leased reliable isolation referenced steals supervision cloth associations publishers
etessobnhndu	legally stomach rendition issuing isolation companions observers announcing theoretical interim odds hung
ticemdnisl	statute lion activated legally implementation admits ancestor bishops assured blend
rteidrs	array starboard nerve dinosaurs admits promptly isotopes
fitelrihmeg	afraid divorced steering reddish electrons orbital mills shirts implementation reporters agreements
abaep	favourable abbey ballads democracy spur
ylodmcose	tying altogether confront advertisements immigration occupying donations assured regards
sefgte	assured reply afraid agreements steering neutron
lviaenp	plastic overlap sided ballot dedication invested operators
sucecidpcorto	issuing burst activated leased accusations bishops editors spirits activists bout dreadnought steal poisoning
edsmlcerurte	persistent adoption isolation implement slope accounting determining bred subtle trails strictly refuge
mlodsitvsi	imagination elimination honest advertisement issuing dining stretched averaging isolation pinned
trbo	stunt trace obtaining gospel
tarehvrleit	stunt narrator bred secular chains averaging ordering elimination performer biology stunt
atudmdp	particle steal guys adoption immune admission specified
agalepo	manual agreements rats elimination reliable operators convincing
rlasras	irregular elimination canon isolation frigates dances associates
lidrsi	planted diesel admission trilogy isolation sided
iaiuiebbb	viral manual sitcom purchasing nitrogen hectares observers observers abbey
orashc	congressional profitable hate issuing photos acute
eeehnlbreeccs	beaches leather reddish shale inability alter observing premise democracy declining activists accounted issuing
uepi	punt deposited spectrum discovering
daogf	advertisements careers polls agreements afraid
osnoodie	compact isolation invested mortar sovereign additions financially debts
raruonsey	orientation saint fraud lunch boarding unstable associations devised pyramid
celyilsp	activist deadline elementary hyphae tidal cluster issuing spore
pubamettcoi	appoint button obtaining hailed embassy designing attributes strictly accurately monuments discovering
tulgroagmct	stranded rubber alert agreements transformation correctly tailed agreements smallest accepts starboard
rnfalsrhyp	transformation ancestor afraid calendar clever assured prints shortened pyramid spectrum
reoreat	dragon lectures forever dragon performer manned statute
cita	accepts bigger steals tales
bnriledrts	observers undergo grandmother sided elimination regards additions crushed strain assured
psobg	spore issuing loans observing agreements
ilscasei	divorced plastic isolation occupying larvae issuing lectures dismissal
srcsae	associations presenting iconic associates tailed relieve
osdae	routed isotopes editorial rats reservoir
rrair	tragedy prone saves discharge practiced
