antiviral	across national there itself very increased relationship appeared late
percussionist	part episode reached critics under ship sent itself often number interest success their
comatose	considered once must above troops opened special entire
cairn	children around interest rest near
meanders	moved every almost number developed events reported service
solace	species outside list added command each
fatale	family addition these aircraft local east
repulsive	replaced ended point under local start involved video even
hobbies	himself other based battle increased entire spent
scholastic	section control house often land additional sold told include case
reload	return elements later often army developed
paddlefish	performance addition different death land ended force increased special hurricane
infusion	itself noted full used support involved official northern
colon	caused other live once nine
naturalism	national almost team upon returned appeared local important site modern
ulcer	used last city established result
accomplices	appeared club close other music provided local include city entire state
minstrel	modern include north served tour runs early lines
anomalous	action near other most added left opened until spent
accomplices	action century called official most people local interest chart entire series
assailants	area success same album itself life aircraft national their such
sirens	ships involved release events name species
appended	areas play performance eventually near directed events despite
restricts	race episode studio tour return increased central title scored
clearances	company little ever about reached another name children every seven
replayed	release even party level around year each death
subservient	seen units battle school eventually route video increased earlier noted turned
distilled	director into several than itself last left every different
obsolescent	open believed several order lines either should created elements nine that
sonnets	south only near near early three small
stylus	since than year list under success
paracetamol	provided also return almost case ended troops areas must over little
palatable	popular action later appearance told aircraft became life either
uric	under released into completed
runes	recorded used national either state
interpreters	itself nine they either relationship parts remained established tropical eventually reached state
diploid	developed important process list only itself despite
herbivore	head episode relationship better island victory outside replaced event
tremor	term returned established minutes office return
purchasers	praised until returned career home almost scene elements race spent
detain	decided events those areas itself noted
banal	built about never also lead
adapter	above director attempt provided then either received
persecutions	previous early released side episode cast used third increased order number ships
dammed	described album months music episode described
dromaeosaurids	development rather often member album entire often season announced until role increased director seven
perforated	point ever rather family official remained attempt three early developed
macabre	main able characters album battle relationship eventually
curveball	cast under rest version early best army lost live
scrum	sold common road until months
ovaries	only victory around route include episode section
livelihood	late included various established level island help office official described
omits	often minutes increased that successful
transcendent	third reported announced noted similar close each noted different events never term
overseer	over victory established release small each even runs
cheeses	character history events episode similar event small
footnote	formed over over their national opened those even
biomedical	battle instead often more every died itself come another least
dualism	different used aircraft located interest start move
inline	included never located increased nine earlier
starve	short then around runs version each
bumped	based used music positive entire directed
pelts	people entire lost this school
diploid	days instead performed least others instead described
adventurers	also described very events northern there used rest even recorded section
uncontrollable	until northern claimed open number those reported outside located late another built lead either
appended	area public placed event noted developed elements different
classy	considered least added seven short years
scares	seen common another released early section
decor	died early created office reported
lurid	love until role important development
moulds	music outside until list days seen
storyteller	small these opened rest year television ever last life ended recorded
coalitions	city often areas love into tour into open north same
recessive	route elements command established states should involved video earlier
intolerable	included north times outside lines established remained also become life ever
dice	development initially continued established
recessive	relationship episode career eventually since spent initially version ended
accomplices	also construction career office move praised last increased common elements similar
impala	interest miles possible above life above
autopilot	album until turned ordered present important left once they
stiffened	such television include former featured ever noted even died
edulis	events development under lost involved sent
shoved	said half ordered version elements described
solace	started others located aircraft city early
hobbies	half open body born itself either shot
readable	released eventually about different about before list events
assailants	able successful scene addition island last attempt northern tropical style
devolution	decided even various office love until that into office name
triumvirate	than record initially upon modern various included remained aircraft their elements
forays	field once returned across year site
humorously	human under match once relationship once until season live years
consumerism	country official number scene upon moved east replaced important seven moved
orientated	once recorded include earlier never turned available three every death
hibernation	home island built episode role north added that instead others never
revamp	reported early victory available most popular
timbre	told important minutes both record either
deletion	decided each local eventually times initially other never
anytime	also number year turned increased made event
amicable	another member important critics announced built land earlier
