counterparts	scrum robins runes informants stratosphere deportations tripped spinulosa masons truthful stiffened assailants
iconic	firecrest acoustics polynomial unprofitable diversify acoustics
concentrations	acoustics commoner inflamed accountants herbivore independents pterosaur profane calculator utensils hibernation hobbies interdiction usurper
consolidated	scrum foundational infer usurper volt aldermen sirens admittance taunts steeple hepatic edulis
poster	spec volt asbestos steeple heartbeat transcendent
depends	edibility nepotism apprenticed defaced unhappiness edicts escalate
realism	preferably nematode macroscopic plebiscite airspeed osteoderms impasse
operators	molded appended lettered arrayed parable steeple forays urbanisation osteoderms
submit	escalate nurseries obsolescent ambivalence dice attest
transmitted	stun craftsman calendars unbearable usurper impasse firecrest starch attest reverb addictions
demon	adorable aerobic omits coyote intolerable
persona	aptly seditious prima escalate horticultural undetermined macroscopic
variants	overruns parable primal pincer rabbis anonymity stratosphere escalate
labels	plainly danceable obsolescent returner flirts usurper
economics	deterred scholastic bouncer unsupported voiceover amiable disposable scholastic assailants
detective	adorable selfless stylus revamp acoustics pterosaur biosphere overload decor
thirteenth	stratosphere photovoltaic siren uric storyteller defer reburied antiviral attest chipped
tales	utensils mannered blur befriend astute
beaches	obsolescent veterinarian campy acoustics shortlist readable astute
blame	obsolescent blur materialised ambivalence hemispheres
persistent	speculators revamp freedmen assailants filamentous astute starch testosterone intercepts starve
steals	escalate starve persecutions laymen floppy usurper
celebrities	accomplices deterred placental pelts obsolescent profane fireman strippers sirens heartbeat asbestos
recall	tricolor benched accomplices cantilever clams slander
economics	hectic screenshots bodysuit inhaled motivational amiable biomedical scrum usurper
elementary	receptionist clientele readable impressively delle unconvinced stun mannered primal lymphoma
consultant	screenshots conceptions interpretive usurper sunfish floppy steeple cadres informants steeple
crossover	acoustics transcend holed astute assailants coalitions overseer returner tricolor
broadly	obsolescent brushes compliant carousel edicts alibi tyrannical
conventions	accomplices combatant unsupported ovaries nebulae unconditionally standstill discontinue coerced interpreters osteoderms
depends	adorable pelts apprehension heed uncensored edicts usurper
penalties	speculators healthier inhaled materialised blooms stun tint readable asbestos
comparisons	accountants corset omits speculators valour friendlies discounts osteoderms potentials announcers astute
orbital	horticultural arrayed obsolescent disrespect pterosaur vanishes blotches
maritime	impasse parable friendlies disrespect staffers disposable imperium defaced
stunt	asbestos stratosphere buddy annotated staffers
disturbed	edicts pianists usurper stratosphere nurseries predominate obsolescent eels edulis
renovation	transcend veterinarian interpreters forensics overload caravans stun disassembled docile interpretive
poster	appraisal compatriot usurper attest befriend tricolor
consolidated	scrum coyote uncontrollable usurper politely plastics filamentous edibility baboon steeple debutant adapter
cluster	scarf clams functionally usurper steeple selfless driest
unrest	buddy infiltrates bronchitis recitatives osteoderms stratosphere
spore	asbestos spicy compliant tripped returner
unity	nurseries inclusions airspeed utensils hydrophobic
prominently	spec transcendent coerced amicable biathlon undrafted sensuality unconditionally attest clientele tyrannical
anchor	catfish intermission screamed shortlist potentials drifts
trout	utensils prima corrective superbly staffers
persona	spec telecommunication troupes asbestos solace uncontrollable mace
traces	steeple driest dammed screamed denominational astute
labels	flea danceable obsolescent deadpan classy assailants
frames	afternoons uric saline impala delle usurper
bedroom	obsolescent pelts edulis freedmen docile hobbies omits
inscriptions	biofuel unconvinced usurper scraped brushes diocesan apprehension starch biomedical codon intrusions astute
tournaments	stratosphere countermeasures rupees trite inoperable fable impala lenient anomalous stylus assailants
uniforms	hurled inline linemen afternoons locusts orientated eminence escalate
vampire	overseer parable impartial spicy militaristic prairies hemispheres
sealed	escalate fealty macho plummeted repayment adventurers
sculptures	astute screamed curtail blur appended storyteller lures transplantation decor osteoderms
ramp	uric dammed impasse opposites
detect	addictions seditious steeple yells screamed utensils
deteriorated	admittance seditious staffers repulsive protestors ailment bouncer orientated catfish stylus deified addictions
broader	obsolescent prelates docile fatale adventurers receptionist freedmen
devised	admittance persecutions overload linemen assailants revamp edicts
orbital	polynomial transcend obsolescent diocesan stratosphere bailed classy
dreams	adorable preferably veterinarian carousel impressively osteoderms
impacted	fireman impasse spinulosa payoff acoustics pterosaur methodical edicts
recruit	triumvirate reprimand scarf tripped runic firecrest stair
residences	pretense perpetuated astute distilled admittance deportations infusion scares menstrual escalate
entries	fermented announcers stun friendlies discreetly perforated assailants
cooler	scandium docile forensics plastics aerobic credence
counts	screenshots hoop putative unbearable storyteller asbestos
tends	stun reprimand unconditionally adventurers assailants
consoles	scares foaled inclusions escalate hoop aldermen remission assailants
canon	accomplices hash informative consular unconvinced
intentions	discreetly annular stun devolution intricately stylus tint couplet intermission asbestos
overtime	morphs overload defer brushes pterosaur discerned impressively persistently
unpopular	pumice encephalopathy aptly foramina epileptic nuances plummeted danceable brochure
socialist	astute corset scares disassembled radicalism bloodless siren assailants steeple
recipient	predominate perforated scutes hipped spec sirens sensuality anytime stiffened
presumed	spec freedmen nematode astute surveyors impressively telecommunication edulis
isolation	militaristic asbestos countenance alchemy mannered starve firecrest forensics intolerable
uncertainty	subservient interpreters accentuated nebulae tremor stylus mannered discontinue annular attest mycelia
recruit	arrayed denominational acoustics propriety buddy diversify storyteller
horns	shoved bottlenose credence inoperable asbestos
sealed	escalate befriend fatale flea perpetuated edulis
client	accentuated aldermen biomedical reprieve unattractive stylus
yield	cyber dice remission clearances edicts
lady	plummeted parachutes edibility lymphoma
acceptable	banal scraped accentuated serpentine spectacles stiffened mace obsolescent flirts nepotism
brass	obsolescent truthful radiate asbestos osteoderms
discrimination	adventurers fireman osteoderms accomplices pretense siren omits dined interpretive paracetamol steeple pianists monolithic undrafted
deficit	edulis reindeer affirmation distortions scraped discreetly storyteller
unhappy	sulphur insofar cheapest barristers upload spinulosa typhus
rituals	bronchitis disassembled strippers curtail laymen clams astute
unhappy	curtail inline photosphere patched aphids epithelium nymph
listeners	alchemy distillery usurper starve meanders antiviral fermented driest usurper
testified	starve hectic astute stylus hibernation afternoons diversify lenient edicts
fore	afternoons conceptions pretense peppers
capability	acoustics parable appreciable patched obsolescent biofuel ulcer fireman strippers hydrophobic
trenches	strippers triumvirate yells internship acoustics shoals deletion assailants
