better	briefs elves telecommunication toddler epithelium reverb
their	transcriptions hobbies eels impressively reprieve
south	scholastic overpasses unstoppable truthful hurled
love	lurid ovaries veterinarian entropy
various	valour appreciable radicalism informative omits unfavorably stun
form	folio orbs relays mesoscale
placed	partitions laymen anytime cauldron eater dined
some	seditious outscored materialised emirate
also	amicable locusts screenshots overseer
command	culminate outscored masturbation multiples accentuated nosed deified
these	tosses humorously elves storyteller entropy
state	sirens testimonies amiable tasteless epileptic
that	transcendent hearth astute troupes
started	saline transcriptions arrayed replayed troupes emirate deadpan
also	announcers lettered spec outro
reached	ruinous eminence annotated covertly harem erode deletion
further	freedmen utensils rotavirus taunts hydrolysis escalate recitation
elements	emirate labyrinth edulis malice environmentalists narrate testimonies serpentine
control	contours orientated nematode typhus repulsive outscored laymen
father	filament aphids troupes hepatic eels roast
support	sheriffs uncensored placental prelates opposites receptionist testosterone
race	retaliatory aldermen campy encephalopathy
system	stair yells seditious transcriptions eater mycelia
official	opposites fiasco forays interpretive cheapest instilled anomalous linemen
passed	prima accentuated submissive scrum entropy discerned
further	folio urbanisation retainers transcriptions heartbeat edicts receptionist
lost	lettered obsolescent spec triumvirate
noted	narcotics overload tosses eels dined
runs	recitation uncontrollable natal submissive
days	decor appreciable yells standstill
position	patio orbs stun insofar testimonies intricately ovaries narcotics
local	livelihood overpasses cathode ante lorries
army	antiviral reindeer macho yells
event	edibility voodoo edibility nepotism taunts
could	curveball osteoderms ulcer lettered disassembled
continued	cauldron orientated nematode transplantation inclusions nepotism undetermined encephalopathy deadpan
action	asbestos communicates tasteless intolerable outscored nurseries
rather	recitation amphitheater tactile housemates edibility recur
season	serpentine edulis aerobic superstitious overruns nebulae
class	craftsman livelihood anonymity shin stratosphere
even	epileptic valour encephalopathy nurseries
lines	laird infusion nuances eater secede
level	leisurely escalate voodoo edulis labyrinth
told	toddler orbs lettered drifts
land	lorries attest nematode decipher
months	malice omits nebulae turbofan horticultural scholastic
started	scarf tremor arrayed rotavirus testosterone erode distilled
best	blur eminence screenshots transcend
developed	distortions elves volt environmentalists lettered orbs potentials escalate dualism
others	orientated tyrannical hearth eater recur substandard
political	perceives overpasses lettered interpretive thumbs impasse codon announcers leisurely
used	ulcer sacral edibility deletion
little	lettered infiltrates telecommunication timbre labyrinth elves
possible	plebiscite overload surveyors sheriffs insofar baboon linemen elapsed
from	footnote restricts opposites meanders
become	brochure epithelium carousel osteoderms macroscopic eels
system	scholastic yells sacraments tearful emirate macroscopic
children	cation housemates intercepts laird discontinue reburied edulis nosed
play	polynomial livelihood accentuated yells
other	overseer tricolor healthier eater radiant
court	conceptions omits unconditionally repayment transcend
included	intolerable natal customarily lettered unconvinced deletion environmentalists decor
directed	dentary impala radicalism edicts coyote testimonies escalate decipher
until	unfavorably nuances transcendent intercepts lenient
court	comatose overload usurper radiate taunts
career	catfish annotated recitation elves edulis radicalism
lines	lorries independents natal eels substandard
court	catfish overseer urbanisation reindeer tosses
created	credence recur eminence anytime testosterone edibility discontinue
service	suspenseful encephalopathy receptionist vanishes impartial combatant encephalopathy
team	tosses escalate acoustics militaristic
line	lenient impressively nomads epileptic
claimed	channeled lettered anytime inclusions marvelous eels disposable
player	partitions lymphoma ambivalence yells epileptic rectified
south	solace opposites unsuited transcendent hipped
parts	pastime apprenticed reverts taunts sacral
became	broom entropy covertly aunts merchantmen emirate
tour	transcend outro unstoppable reindeer
under	unstoppable nurseries diocesan epileptic replayed
return	reprieve escalate transcendent utensils reload nuances
third	transcendent hash informative rabbis dammed
could	coyote overruns uric lenient debutant
believed	barefoot erode linemen impartial entropy voiceover eminence disposable
sent	subtype encephalopathy nematode triumvirate
others	overruns telecommunication humorously emirate ravines storyteller
month	morphs overruns nuances tint heed
lines	laymen internship nebulae edulis starch
city	classy inline tactile yells
ship	serpentine hydrostatic impressively preferential
character	cubeb handmade annotated recur airspeed cairn triumvirate eater repayment
rather	recessive anonymity transcendent hemispheres emirate reindeer
local	lures overload codon annular lorries
modern	mesoscale outro distilled edibility receptionist nepotism
from	filamentous reindeer obsolescent motivational
times	trite independents militaristic eater solace
became	bassoon entropy contemplative adorable malice entropy
considered	craftsman orientated nebulae supper impasse debutant elapsed reprieve escalate deadpan
claimed	calculator livelihood adapter intolerable malt edibility dined
every	eels valour elves returner yells
included	intrinsically nymph captivated labyrinth uncontrollable deletion elves driest
