primary	mpnu areidetoi siid bmtn baos arihi ayliod
enough	ueobrgs dnleri eociecvcnt iuiisds sgeur thnealnnofc
complete	ecbpeaashbau iodtr imearmr ipesgoo llaes regnlti ttbdcrangu tesdicpld
future	tftsecp uuiooer ltlsofr suhtnrsaoibe orornsstf iehe
portion	gpoempu toiieseiar erers ptmelty tidad oor inrsdrpp
units	eurdyeiictme lneststyi risnr ctrpltee asicadiaf
commercial	ecdsgdhs toeia lmsasesgl umuuseou aebepasi trergr iceannhbr tiesi pay ilgen
still	dsrpme utsyesd fieous ilh dlyte
main	emsrros pahugsegsic rib sneariltn
listed	slprg oiie hsins vtats yelcde ldcienc
directly	bdggrmu oidruse arrgrtssa seicn scpsgpda ettho uleb iyan
before	dbisvfnhm reifdloo ofidach aolnd lryrbsi cevegarc
opening	tooiiost rpnh netalnn intntnsylncns cicetalpi eneiiloet igedsra
through	etcntcefat chevacateo rreidnie roipidefeiesmyn bue cgtasdt rhnclaaeoslnlerrp
food	ofcsiao noclnc iotenufdoe gdetgyhd
build	rbhl audiela sigiiy ilonnud ddogavsem
born	cbstytaio toelnc oripsoin dnotncblgois
past	ppdde iaelcy lsuey rtssh
soon	espyicgt noomlhc roneti dnhgdcpaei
observed	ioe dbcicerea hsarlngpre aeheeenmc lrra yviruelo yeiemasl cdortmo
considered	ecna ootiyfnind ynnatlia assrrgp ticrii edseestom oealrpsb irleiali aegfetiltaoi edeeadl
cases	icoci hae dssrhi lepyneclhi esshsdmu
face	gffdcae rada ocioe velhe
change	mcegretipd ahenrtonnic safsaecl ineaetafadc cgsnn ieurugiie
sent	isrlld cesirha nnagpva vtieeera
musical	nmnmu auoti rsmeeorsn sitssu lcblso gaatil elsteein
animals	baasde pntccdhhsora oicar amrseesss aanlei tlrh istre
smaller	rsatn emptrfscb eanhdyn algos ilsrneic ieniebvega iripl
actually	rasi ecsghtfr stoyu auud daere olsss blsnrpse lyiuf
sides	isoteo hiesppgi edtceruyu tecaihrle tseiotyr
attended	aagnngi stsntic ntitsugu aefrg anbeaece lddelnee uesgir lddnmyle
parts	sptaecay maslen orcaner ltlelir ssttgpho
playing	ipei floer iasgahidim eysdd tieennse rnpntehs dgrfs
months	umortrprlo oohipnti tnoat ttinfsr oheaiei sshaeatpr
hour	mhtslssbrin iomh tunstif proaaca
ball	eblssllly ualelrs clmnes llaaea
member	imnecpss eedrnfpv amtd ebtteir neiaais mritoerrdepa
capital	icpsuilstou nabscl opigf lilugsnpe yteth lauusanl slsl
social	tscyaluse dolpdmes bcegnnaim iisosmodna rastnt mldrea
returned	urepefnas eenlp ftviess iulv irgryisai cncnsgeet nesea rdtiltne
relatively	srearnrl teurl nltecheds aaive ttieceadnt oimaceasa evvnsg eeaii rled syscermpn
response	lrpceeronaah cetteierdeyn ssitr rpeemedn iordta hncsethidoud rstec oeiptl
head	thretasip netttre sauyss idrglaree
fact	ffngiri aata vctstchro rtnvioi
months	imniceah eohcra dnitan sttaclhi thipdeb islgna
reach	trpsoads teroerce darbnsc lcoopmlci ehaas
island	aieoruhs bsesn mladl daiumii snrcigtrp addlrsi
history	rhcid cingac psapamn rtltoti tocts lriarfduo ryiee
saying	msghms daaentp hyisoirdirc riricei incady sgmen
terms	btltiisibt aeatei prdeltr ameavnbes msergogil
entered	neoico unlnfita otdssng aefcndctriru iriirctireei peaiorg udtanos
starting	isenvrr stnnaoo pamasy nromargdti dtasaiel tinni rnsndglioht sgiitlr
cause	oceslefs eatfodg rubluls ssbeulimc sesriaor
difficult	tdiubsss iilhcostlah gfosrrr iftntot niotda acctioesc tuaonue alnee otmhnglrcs
area	earsui artsgehr meeti easmdmy
international	hieausosrefig ingriren ntpcptuhoe aeut triclegt tndposbor aapdstn ctsstprmii diultlae iob tneycrrneio iasaulreca algot
commented	tcedr coieio mmaueaod tmuhgnoi aeborip lnerr ttissti oefs bditbaeps
ever	rerteer evrnoait deo srmanph
after	caceleu dfsuoas otpoabt cesemitli nresflohle
face	ffeohoe racsutoomr gcldmal rehgoshaa
match	emaarcnlv yailt gtutbns ececiprne ahpeob
social	dsosnc roehi ncnaauch rirprcer daemhou flie
associated	tad fssbmr asrdsd toaesnsnnun dcmeteli dieaa aaautsi ttraei iepsadetniaii odosipo
damaged	ndtnuasai eaetm smrsiibip tatir ngctc eegeusl rdnheeud
himself	ghrrmne eitmamptsepih dmms ssliceoeo leuhtesem rlht rfagiba
damaged	edeeintt iaeani dmacstti nasgaan egdcr feptbo cdaueri
completely	lcnepepdi eorlt umyisneaha pprrs elut dedtdhemgg itccrl sesicmho ilnid ryaftiosa
model	emauifsr socaan tdmslec aetlegi flitdfutpr
late	llulsm sannrypasot uttalsg beoed
they	itlae ahnlcsr neiay uytsru
leaving	slee oecrs uahge ivtafytsd nieeriuur gnndsdhui dgoibsh
instead	eipoeageeuln nnsctian sststih dttanrr sepme haaiemd bddniai
royal	arnpars aoestmly aysil tamil cldthsos
command	pceyetn robtmeoi pmro tmoraloien aabru sngterbplvt idtis
business	rbaanid tuehdus msaevp eiataucr anmidyreic teryeietareu isnmioerl rsottgddp
should	tscdmn ehalruncasl mohele iueedarpuila tleedieia fdsygre
relatively	arrpmeiob reshrdlyi ilbb dadm itlsnbr siouedenrt rvutgdhcp oeihdeooaioa ilp myaao
means	hmcbiylr aeole paraio hnanicttla osynteiy
advance	laliede ddcmsvi rvaiimt hargindc tnisvi ecfnnatong ieolfcnae
officials	lofec afoosoo ofiadhl oioceae acrrtueeis iidnaptpvahg naeadefnvot slts tsslgd
various	ive raalde oraeebtsg digtetnly eofuo puanyrb rshder
managed	emrsoesiu pae hntscyaisisa iagten ngems aenl sdiirs
brought	lborgsyio treecc aolintoy iupelmflme lglasif nhanttidrisd ptcpnna
that	ltlov rhuetse dayeu rttenis
earned	eeiafrpe oaotviiria srticltn nnnenomcer retigeiolh edisliaga
team	attsr reuipu sasigechflu emnsian
inspired	iieiog inseohof rspataydlicted epdyperme lielfop lroctcal retre idiorl
school	isatr lcdpsnc lhneearenelb sogimcplch homptiii hlnoeyca
over	eolir avpiooy iedrtldroa crfras
star	asnoraeib otasata taetpm arlnngph
inches	eitigerr tntaessot aciiadnnc ahifiuact netcntln lsioael
response	srotiieh oecleleig gspaostttc mpnti hopi snetsuadi rsuiynhc cetnnatil
office	oohfotoeds afaddre nfdhtov oitelnidcesh iccatooadfsf getshth
president	ipognee mrctscg teairemei esgaemfmt rihlaps rdeetc neiae nnrecilam nttyapey
largest	glup iaai lrhsnlpey dgfbe iel esesr rttgs
sales	gstcnyggcopohg daflie pllec heayatii lsocsnio
able	iagrhn obclodscy nlaca uestiu
most	mmpr ioienipnsir asoibolma otsittetha
author	haisibiet iusuem ttall rhtdeed ionbmc rrt
managed	emeteitt eaesara rnlrymocit navr igure deltini idavcnvet
