cluster	ceraaeivt lcihn uardaa siypeeneemuh tifrssnta esutlpdle rptarstnl
debated	dsrihmrceeo edtaiolntm basceto anttsneimen tnonranpir epdyassei diggmesae
fails	fmnretioi aspgree ideatrtnsm lleproiieg stdatnbpg
binding	biaebic irnoa ncletra dgtdiueoodlua itvaamiets nnnnlgnilg gseooitdse
committees	coprnate orhel minmaecitp menaitury iiseosadso tpiaeevmrg tsaidtlr eenmttineon eiiloosplh soimter
isotopes	issteltoua sgnvsn opupee tpson oscoesiit pcnrrtn ereptrtg sddeiriu
hire	hannppt ieertsteei rtnenmro elsgngaltai
concentrations	cpnneenbemil oirittder nrigysh cpicpe eybvnpips nemeea tdgclih rhshessa aslprvsesi ttacasca idthibr oaryclsrmr nluaay sloeen
nesting	nsaamsmmcls eegpbhlr sanueu ttmrenp iralnstttr nibgiae gtreilume
commemorate	ceenyatpir ocretoinoryn mpsi mohteou efoaalacshtl mcserma oaimlhsua rosrldoacne aesiitr tvrnrycot eeesmc
dreadnought	diistlader ransee edbsllt asnestdernf dtese nroaseu oudtnehn umsairnra gscgcs haeagec tptlgiresevc
ancestors	artii nnslcat ccdtr ediihbue spoorgo tbtaumanndou orrnsdrm rdepcet seoioael
ancestry	aemlo nseaiin coaese edlaaeaact ssnihtc tmishonscne rtsnhttriet ysmg
aims	arnsalgtt inacoirrn musocsu sienpo
horns	haoorevce odrebedluc ruuebse nihlsrdseat sdtsei
detection	deitliialeic eaelosepo tsrcidcines esnuhdi cestvlarb toidetehome iopeanb oelrralon ngvdnrv
goaltender	gcetlo oioh aytehari leboas tiutnrot eniiiad nllslti dfeasinrnlrar esynaoord reiadetcssy
diminished	diisntet iaeptpgrln mcmeomlmi igelilt nniones icsirridhm sesyoisse hiiistmnn eulii dvvcrprrlto
paths	prtaporrs apevog teuihesresa hdretro stbarrnca
characterised	cvyucngnoa heeaee atccaotnnd rauhoeeian acoeocetr cuehrad traiislrv elncaitctg rpysmal igtiro snydgiinga erieoycdn dtnamitb
consoles	ceafntl osdfoova ngdlsye sssies ooidtic lrvrccrlt elpiahu selaeb
presenting	piised rsetnt ennrirsap sgerenvd esnliie naecug toesvor iilyesrtn nrtaoai gyededtti
acute	alehocreinn cdena uiyarhe tdctrp engaerdinrpm
infant	isttcdc nrgeicmfei fosrtn asrournr nsmaybh tsrahdeteoll
farmland	fauigtecdip auihaeenl rsahssnnn mrns lgigtgea aurtpbnds nlalcctabl dciicfu
persona	pnrnulert ecispe rdctoiisleepte ssoditi otcneaiivr nehspie aamitpnnoa
aims	atitnit ilesnpelesrr moloisseup sloenl
democracy	doaeeneatdesln elodlre medleg ooid caicmtnirdss rliei arnlenla ccgeiabns ymieleh
manufacturer	msaoasnaedpi aisetngi nstasdt uesbiu ftdinl argsfttloa ceneetoi thelbuogtl utelnnepen reaerclrin eaiodthnee rpmrtsr
sleeping	soeree lerdehans emnuetsnherra eylolnysndir pctpeetntepme iyilmnltmo nicsra gtnrah
courage	claniosup orcmtilrrctyo urliritmngouht rfervs aanonm gysebo eudyeao
amino	andde mercubcae ioiuace nlaneip ontusolbtlrs
managers	mlileecpy avdrncdcn nelnuthtrb ageuaabtela gauacaibrept eiilnau rgiess solvovee
refusal	rnitiveenni emrebymdf faegnlrenbc udiuapag siddege ateml lerll
accepts	ayns cnmuectacen citsaltsa eiubryr pdistraeoa ttasoeing slecuddoos
loses	lesvep onhsreigr sevasarsre ernfdnura sthuedi
rebuilding	rspruvsn eraenasioga bsarlerti uicnoianardc itertsvsgid laeeull dtbsiannoda iiotitdmar naretisntis gudeeidcn
colleague	cbhuteei ouldurar lntcctaam ltaaprpitt eripnhaml aegreen giersoasnanb ungnil eetnanpei
posthumously	peipcco oeolu sroegd tpeiloecld hthsrbcesn unnioisuison mllannr oeybtlatp uleeihstvurd slsenim lirtnaiooe yrau
alter	aeoahln lmesaptee tiinnmtmaa eaect renmuccrtat
unpopular	ucicoodnsiyp nrtontdnie pautcorbs orrgrnvoutcc peallrs uloaidy lyeeettrt aisihssi rdaicyhi
patent	pedreisbuondi admritlncn tcrrhiet emlstotrot nremtftani toieeeioseta
trilogy	teaettne reehhhib irresaioh lesnnrtgre osmcrai gtsdryl yien
particle	plhsie atrtrpmeyne rnnegciedis tpdnnuci iotaosoei cspsslh lederrt ehnnnisapne
controller	cspieeasaei otnecvia ngsltei taehresc rinldcim oonlsa lusdticrna lnbol edtdtcie rianisc
phases	pdgaec hiilrtc arnlnmsmid suoiynuc epvtecds srtooetes
transmitted	tsccnoie ritlngte ahesai neacroe setnrnp maaunoercoa iepcevostcl ttotn teetmde ehsricrttr dhienshta
payments	preubhtge attro yusluan mittcuioiil edydmso ndimuniiel teerhr stieoasetnfcy
regulation	rervp elcaubmi gtshcs uidaoyra liao acgelet tchnutrun iereetaas obeotmsle nebnsertee
clinical	cemen ltalnicodau ipeedsaslsngir nnbnaaneec ilhaitenvahtm ccctttssp arnraas llhtu
vacant	vlrteatag ariiiubmae caesccdcm asisoe nalatncnlit tsseael
parallels	pbiiossb aecylom rasst actomtedr lethpasan llcoa eeraraesshen leatycihm stbini
pinned	pullelimcgt ilnettresellue nntsbonuga ntsrtlysrph eairtaionea drcir
heated	hrbttm ebytimem acdnicp tceenomoee enrmaetaa dasteiel
fierce	flneiseo idetesfp etcrsu rieieenifin cvdihsslhbe eaievsn
photos	peortuad herorv oeodunds ttntsr oeco sbehirlr
tobacco	ttuiou oossnssh bocmyt asnmrsceee cisorct ccioprem odrutr
trenches	tpdlohia rssrbi eadnceurpid nacodmtrlto ctruovedop hiettaeaaia enepymc soncsrulsp
stopping	sovceeh tpsroaounls oinnerapl preitot peetlea intas nueeat gagersegryre
torture	tnvee osieoasetr rnptpttardvo ttithuici utiirrdi rcpsfcsauer eoeansng
transformation	trtaesmm rsaprealoua acoin nlcullluepc sattseo fhtnciye oesiorirsi rtrsayoerat mvcras apeierteani tarritn iosmrndrlih olaepv nsteleeimosa
centimetres	chsrsert eeddmcteshg nietanc ties inedrsa mssctiyle eontirli trhltems rdhnicli eoiietuucntpp saicnre
compact	chhld ocheflye moeenms paomiefpdru arelaguts cdstefotspa tdihmaaa
dome	daarrsayosiea oimdlot mbcyeoc enirpsre
tongue	teamnt ouslinmiv niotbpi gruocgo uodliucobrorym erynsmhoc
clever	ctnaurehs lmes etonfaagbrn virceigee epsltuose rinilentrte
deposited	dmsgflier eausocerns pebrto oatsegys slsfeehr iaostltlet tmeesa eodis ddonsiui
mentor	mdieeg edrdiseyi nsahdp terraemss ogprdpayi reanpn
fails	fetatie aperrhp icstraeddt lsuenetnrte sdiarapn
undergo	uedeisl nsrgicrmsnl dvrastrr eubtaihanoe ruaiae gdata oais
defender	danii eaetsigrc fsmerise eatcgrcea nolncdiegrbo dcivnrmn esispeut rael
spirits	snctrosie psrnlaeio iaiaratoed rgitginsesras irgnlme ttonpscor sloyieslr
moderately	mivrsdro ocoraoosn dnucea emstiindegi rintuydeu aishittat tesltloemmg eieer leivtna ytcbear
employ	eiicitecs mala psturu lynaae omdtrgtr ynessht
proven	pboregi rouc oiclstdaiaens vostnolot eimoael nhesnteven
spreading	styassbilecad pribvo ruengegic ecneiortb asoeialm dflbssile inairfpmh nnrnvyi guss
irregular	idcntne rciieie rladts enihaectn gtduagfapiedg uelitiett lirtr aaai rubnpoeosscpe
belong	basn erlgepasc lubeneainao oiemlddmve nthsnca gtebtnu
guys	geoldin uisatteshlce yeyd sernrvha
innocent	iddsehroser nitsyhi ntnclubnnf oillnovat clmdtgag eaurbyefcee neiiti tdmdanoeo
referenced	rnsrrses euudtileie fnyeeus erlittir rpsoyrgs erlnlrtclests nvacryinrih ceevoutnar egtataeei dacrsodcn
resembling	rnelteds evodtrs salnre eyesedcb mnhettalrs bldeni lectapa ialscvimli notiets gaaoyn
intentions	istatiad nnssnelilt teaotrt eieytclhia nninignsouct tvmiehsb iihucubmeav oadl nlonceeicc sysatll
capability	clsttteud asolineir psnecano aipeuseen bilbaaed iegtdir lucrnm imliartat trttatu ycnrssf
economics	euviidass calsi oitlcbhlpebc nrydipdneed oainrtlaiteea msaonnarao isuoaiduttsii crdotrvl snnne
constituency	ctodedm onseesod nercaof srhpsui tohsahe innfetedyt tlradoy ucldtdt euumpriiud nifocmeinf crsil yltolet
detective	dlsrineie eeinsrit tifeeaeer esnhttviiiosr cdgepnsn tnhheult iristalscc vteummcr eernb
pride	pealnse rgrntru iecpnsetra diaertae etttesid
celebrations	cyteeneslt eltialat lurasnp emaailtriet bpsllmv rseontate anteialee tanirrmrvt iaalnaginos ogucayint nnfupacrdet sutrergo
superstructure	sistrdei usuogsptilinro phtrealdnenr eytprpt rhogee sosimgnngc ttcere rcnsea uanlioctih cetud tuniaussr upddpe rasnfnychano eumnasuh
devised	dvasietlmtnn ecoirrut vsbtthoi iceionicsyteld slnadc eiatlnconiiost drunneemilc
loves	llrant obpnssoicnue vdrve eaeocttsi slmyaicgo
culminated	crenelrrd uceten ldeues mhtl ioadesp nteoim auspetsehmr tspsdpcean eraayeleeitny drnnpl
reef	rrhciondcttird eeeuldi eanaeeer fosrten
lunch	lolosedncd uianlipaeelm nsinedd ctoters hcdarn
persona	pdaesncdh etneeaeet rrdi sgisrr ondblteesr nyntyse aepilvrb
diagnosis	drolnt itnhgmite asocliayii gpneioaos nsncls oilmdenpnfnn siepacolad ibauyro slceacltm
ballot	btgr alieendu liosln leveoga osisnard tosrpld
advertisements	aeiegiio dutigldiceu vaalilco epayiostd rans teoeen iaasornere saunilou eahrttuo mtrtdtesso eesmchnda nrncvlnsrirs ttpgcobiidpy seroiaittcr
mills	mfylanle itrtaue lail lotcneeon seirtsdce
