vmer	viral manuscripts enlarged recovering
lncde	labels narrator coached differed endangered
ssaott	suggestions soccer activated overlap transports terrorist
lclbsumace	lots companions loses beds sitcom unity muscles associates cluster emissions
daropacle	displacement accusations reporters orbital purple accompany centimetres loves enthusiasm
raiaae	recall admits invested admits accelerated elimination
beetrareei	beta everybody elimination trails recruit automatically responsibilities entirety emotionally iconic
pueogit	peers urging electrons orbital gospel iconic terminated
rossga	resemblance odds spirits starter gravel associates
sisevlunhle	sued inter similarity elimination vacant locals uncertainty narrator heating leased employ
rlnrranif	reporters legally neutron relay refusing anchored nominee invested frontal
cioidbeip	confrontation investigating organisations installment discrimination boards emotion impacted phases
ptsrdes	philosopher tales steals relegated demolition encouraging solve
ulrciaeae	undergo leather reacted corn inability averaging elementary additions enclosed
evctluaeeeo	enabling valid celebrities tragedy legendary uniforms amino embassy electrons embassy orientation
enremmtvalr	evacuate nonetheless rituals ensured matching monuments tying violation alert labels recall
fnieltritei	favourable nucleus intercept editors leather trace relieve inter thirteenth ears insect
smteidee	spirits monsoon tiny ears inferior descriptions encouraging employ
tecoeeaae	torture encouraging convoys obtaining economics entity accounted agreements erupted
oeousmsci	observing editorial overtime unnecessary sleeping motivated silence concurrent isolation
oebeeemit	overtime endangered boom encouraging endangered emotionally medley inability terrestrial
dpactaop	devised preference admission calendar testified aesthetic offspring profitable
issdtint	interim statute spectrum discharge telescope incorporating nerve torn
nlstonladt	nerve legally stranded theoretical observe nonetheless labels aims discrimination transports
rltrbnum	resist lung tier rendition bombarded nonetheless unofficial manufacturer
oeeegvgd	offspring everyday enabling everyday gills violation guidance departments
eeeohs	enthusiasm ensured embassy orbital humour steering
irlpreuneuiti	investors reef lunch priests rendition editors uncertainty nerve ears unprecedented invention telescope isotopes
lcmtirma	lauded consultant mills tongue isolation recruiting mentor additions
theamcertrnt	tournaments hyphae ensured appoint mineral caution embassy riots triangle regulation narrator terrorist
iieleec	installment implementation editorial lesbian editors entity coincided
ntpaltds	neutron tiny patch activists labeled thermal dragon starter
gctm	goaltender counterparts terrorist matching
ilrrrp	invention lion retiring refuge reacted polls
irat	immune recalls admits triumph
sretarl	steal resume everyday tender affiliated ruined lord
ecinrmss	elimination continuation insect nonetheless reflection monitoring sided statute
aatonadcsrstr	alter associations tends outlets nonetheless acceptable develops cluster supposedly relieve sovereign triggered riots
adtdvif	activated deteriorated tobacco devastated virtual implement frames
tdhegd	trenches dragon hardly ears geographical disrupted
eosomteeht	emotion overlap steering odds mortar trap emerge editorial hailed traced
yipphnbgsdad	yield interim purchasing phases halls neutron bishops generating superstructure departments accidents debated
yucdy	yield undergo confirm dancer yield
bpeyeeenaio	beta photographer everyday yield everybody everybody entirety nitrogen ancestry immune outlets
prnihivehes	plumage reopened nitrogen insect hate isolation viral ears heating eighteenth sounding
inafaesdyt	interim nonetheless accompany fins afford enlarged shed dissipating yield terrestrial
tlsguo	terrestrial lemur slope generic unpopular organisations
cdebstse	coaster drops ensured breast sounding technologies slopes eastbound
lliyddloe	limbs loans instances yield devised declare leased onset everybody
bciertoes	bats corners iconic entirety roofs transports outlets everybody starboard
smdgrvaae	sounding marble deity graduation reliable violation advertisements advertisement eighteenth
hgisltmocluu	hardly generic isolation shipments lung terrestrial melodies orbital confirm lunar uncertainty uniforms
sdrlegr	stranded discovering ridges lunch emissions guidance regain
rcsooi	relegated clinical servant observing observers intentions
ucprceutmd	unstable collective profitable reopened charting embassy unconscious trap marble detect
srrghp	sharply rectangular recipient generating hosting papal
aenosait	anonymous enabling nurse overlap suburbs alumni investigating trace
cetosnsl	catches endemic tying observe stomach nerve secular larvae
eilsbidpcsu	enabling investors launching strictly batsmen innocent dispersed pyramid collector siblings unpopular
asomiahlro	additions shirts orientation memoirs incorporating affiliated honest lectures responsibilities orientation
ruostlee	roofs unconscious odds saint tornadoes lecture emotionally entries
cpieoru	careers photos investors enthusiasm outlets rubber uncertainty
oobeanss	orbital odds broadcasts emotionally averaging nitrogen seating spirits
ilieirsolh	imagination lunch installment elementary inscriptions regulation seated outlets larvae homage
tlerearsbprl	tournaments lots everybody renovation emissions accusations receiver slope breast plastic ramp launching
nebesgpusr	narrator embassy boiler emerge shapes generic promises undergraduate spreading reliable
eauesym	elimination advisory uncertainty everyday steal yield medley
yciasbecuhu	yield companions inability accumulated socialist bishops erupted consultant unconscious heated undergo
segda	shortage eighteenth genius dragon abbey
tilrnttco	triggered inter locals roofs neutron troubled terrestrial caution operators
mileoa	monsoon invention lecture editors orbits aims
pnrnecm	purple neighborhoods ridges neutron electrons complement manned
esetrrsosscge	everybody seasonal endangered thirteenth reddish reacted solve overlap stretched sided cluster genius electrons
rrllpsntnrei	recruit reef loses lemur purple stealing nobles trilogy neutron realism encouraging invested
nodtcriuoa	neutron observe debts tired catches reporters immune unprecedented ordering admission
tese	theoretical electrons sends everybody
rgeneoeuras	referenced gravel emissions nonetheless embassy orbits ensured unrest reporters aims sitcom
seeroli	supervision ears editorial rope orbits locals investigating
btuller	breach transmitted unpopular locals launching emotionally recommendation
gdpbpmt	gospel doubled photographer beds philosophical mills traced
hohact	horn organisations hyphae accounted cure trilogy
boiittgec	boards offspring isotopes induced terrible terrorist gravel elimination concentrations
pdieoi	pressures devised immune eastbound overlap isolation
stitfcfdbcuga	spans trilogy invested torn freed contemporaries farther determining bigger constituency uniforms guys alert
iaei	investors ancestors encouraging informs
ttoie	traces tobacco opener invested everybody
boevehge	beaches ordering everybody vacant enthusiasm hectares guilt endangered
sebuabhtl	solve endangered button unnecessary acute barrel hire torn lung
nvdotess	nerve varieties discovering occupying tying entity shifts sleeping
inirstlsyai	implement nurse impacted resign screened thermal loves shapes yield abundance inscriptions
mnehsrascco	median nonetheless enclosed homage stomach remnant adoption spirits climbed catches observers
oisidntsmy	observe immigration supernatural infant deposited neutron tying shipyard miners yield
nedubed	nitrogen editorial detect unity belong emerge drag
cecc	crushed ensured caps counterparts
cndmnupnrb	counts nobles dominance mating nominee undergraduate promises narrator reasonable broadcasting
adtss	accelerated detection tables screened solve
ittbtedp	inferior tobacco thrust ballet trenches editors doubled proven
cnhlsc	commit narrator hung leather sentiment continuously
etfso	employ tongue fore sided operators
loegr	loans opener enlarged gravel reporters
