ntaept	insect stomach rats reacted spore stranded
spnyl	assured spirits onset pyramid slopes
sntrs	assured endemic stomach criteria assured
olcesd	commands slopes acute meantime isotopes editors
soeseeu	isotopes dome mere isotopes mere persona muscles
svsicuya	isotopes overlap assured viral activist humorous hyphae patent
eeiton	reactor median sits statues contacts entirety
nsieoi	invested isotopes sits sends commit rituals
acdeoi	lauded scripts advisory develops monsoon rises
aceto	valued scripts persona stomach sounded
eesaesdn	recall memoirs isotopes canon deer assured admits endemic
heerot	shale hectares melodies creators commit statues
elprsarp	leather clinical spans trails assured dancer trace opener
ssset	assured assured isotopes peers stranded
leiuieii	plastic nerve hiatus purely viral detect lion mills
hlvioscn	throat slopes overlap virtual mortar assured acute ancestry
eneydno	servant inter depict pyramid editors anchor counts
pnamae	appoint anchor saint immune valid leather
ilraem	lion alumni erupted dancer servant employ
oespo	morale servant assured opener rode
lrhae	clusters pride chaos harder detect
hulevi	shed currents alumni reunited evacuate diesel
ronncer	prone conceded entity invested scripts devised dreams
epuelav	resume spirits runners declare slot papal evacuate
luprrmtd	clever purple spirits priests triumph smallest stomach advisory
trpdtca	strain presumed spore editors statute iconic valid
drusa	odds erupted humorous isotopes valid
cradm	scripts premise saves odds impacted
hrmrtsip	shoots criteria impacted prose stunt assured riots spectrum
sorsli	isotopes poets creators assured client hiatus
ripeeve	premise disco spans reunited realism overtime memoirs
dleeoc	admits cluster reopened leather conceded iconic
imed	mineral employ leased odds
leem	clusters meantime median emotion
uhillm	nucleus thermal yield alter slopes impacted
rlardut	traces platoon tales erupted odds humorous steal
lllp	cloth clause clause spans
pcdnlss	spur screened adoption indirect platoon isotopes assured
ricoech	proven riots scripts honest sends activist throat
vpeemt	evacuate spur reddish hell amid stomach
serh	isotopes melodic trenches shed
iessau	aims heated assured isotopes payments nurse
eorct	lecture soccer cream acute steal
utsdei	auction strictly isotopes admits mentor tier
avls	paths evacuate cluster isotopes
acheocss	halls screened shirts servant hotels scripts assured assured
hela	throat medley alter hailed
erenrnuv	relieve trails remnant anchored presumed endemic authored overlap
sapracr	isotopes valid appoint proud calendar accepts creators
prsodeo	spans promises isotopes compact admits melodic routed
smdcar	assured emotion adoption schemes catches trails
nepdea	ensured lectures spans odds reacted hate
aehlemt	ears lectures throat slope reactor amino steals
uousapre	lunch commands lunar assured valued spore prose medley
oyyho	rode hyphae pyramid shelters comedian
tracmt	starter creators captive accepts amid steal
epiasopt	lecture spectrum diesel saves isotopes corners spirits strain
lsyde	plastic isotopes hyphae advisory sends
mrrueois	amid crushed premise sued depends lord pioneer isotopes
reri	promptly deadline promises sits
dtyennd	admits strictly pyramid secular innocent invested advisory
ancotd	calm entirety acute sounded steal advisory
dhel	adoption shale medley slot
uuor	purely currents corn triumph
enaareaa	tears entries catches calendar prone depends patent parade
repoa	trap develops spans corn hardly
cyirsvae	activist hyphae riots prone isotopes overtime canon lecture
ltsc	alter strictly isotopes accepts
melins	immune hell plots rises entries isotopes
ytame	hyphae stranded dancer impacted detect
srvnohl	assured crushed evacuate interim corners shapes clusters
lredpu	clever promptly realism odds spectrum runners
uiseents	ruined hiatus isotopes resume relay invested strain assured
uisnse	muscles sitcom assured indirect assured demon
rhrelprn	drops shale cream devised plots spectrum trap entity
tcppo	strictly schemes spans spectrum morale
istsad	yield isotopes statute isotopes manor editors
tcrtnrei	starter schemes array stunt anchored drops reunited yield
pryarnu	spore pride pyramid vampire trap unhappy lunch
uaeopu	currents lauded median morale spirits muscles
mhplrele	amounted chains spirits clinical trails lecture slopes senator
tihraal	statute tiny throat trout patron caps platoon
ssrnc	isotopes isotopes pride onset acute
hneerrli	thermal enclosed depict helium drops prints cluster rituals
esme	deleted assured impacted servant
odlatt	mount admits platoon saint stunt stunt
mtan	immune statute patron insect
ctscae	activist steals isotopes schemes hate medley
uhcaddps	sued throat activist patron odds advisory spirits assured
thdlitsa	statues shed admits clinical disco stunt isotopes hardly
estocpt	memoirs isotopes steal morale screened appoint statues
crdiese	schemes array editors disco resume assured hell
icemaca	lion activist detect employ tales iconic parade
prly	spore pride slot hyphae
tpacer	strain spirits catches screened heated prints
cplnpc	accepts spectrum plots unity appoint accepts
aneau	halt entity reddish happens humorous
stoieds	isotopes steals solve pioneer deleted adoption isotopes
tultsa	starter runners cloth stranded assured harder
tdrec	strictly adoption presumed peers scripts
