tseoaht	tour series especially once album held this
hielco	highest include ever line class order
drarl	different required around received local
ioap	involved once above performed
msgeuw	must single general early using written
eoon	event ordered original name
ncuta	near campaign units tropical already
dicien	developed important crew island elements named
wmnddeda	written million name design during event does according
rrfn	recorded reported following night
cssw	crew site still winds
raca	runs action chart according
ptnuduss	point there name using development under still species
essi	early star study international
nadan	nine away decided album number
lelm	left enough level mother
raidet	reached above increased during ended them
grlsle	game real located social live enough
nhgthset	national highway great team highest scene eventually troops
euet	either units earlier term
uiesn	under itself eventually south named
ibfrehetvf	include because four recording every hours episode then video fire
pmns	post music nine ship
wdip	without director international place
noddd	northern opening different decided down
litet	least itself that ended television
grnbiaf	gave road name behind increased aircraft films
pemc	performance elements more character
ieelu	introduced events ended league units
ador	among director once reported
arnhni	addition relationship night held novel introduced
mefafh	move events front available feet hand
eibr	each introduced because runs
yeoslvs	young ever opening star land very scene
efotne	either four once third name enough
elirl	each largest international returned local
virtw	victory instead road time water
rpofhathv	region parts opened family have already time hurricane video
rwpuhru	record went published units hours reviews under
soho	species order hours only
rceii	role court especially initially including
ruyi	review used year into
felwpts	father enough leading where person these show
olcrdiod	originally largest crew race despite instead official director
oliib	official lead introduced itself both
erusgh	every required using star gave held
tbeh	their building enough home
lhfweci	land human free without eventually case idea
aulfraa	away usually long features release album areas
domin	developed open million instead north
ngsa	name going scene away
reladee	relationship early lead around down event either
pahabe	possible along held appearance between entire
imdc	important made different cast
nptlierhl	name population then later important enough received heavy later
idlmuss	issue during lost move until storm seven
medfl	match events described front little
aeeotoi	action even even ordered towards open include
omroettr	once months rather office ended there total remained
imdrde	involved miles different race directed enough
stemsieh	stated told election months study instead east however
oucts	office using company there second
rndbgee	role number developed behind going even established
ioai	instead originally album international
tfpblefe	three following points both light evidence from eight
glea	generally later event above
neie	night early island even
eufw	ended under family well
etoece	east three office earlier considered each
tarce	those against record change enough
eeteclyvrie	earlier earlier team entire command life young various rather involved election
ehgrt	ever head government result tropical
mrti	music replaced thought interest
rvudedm	returned very until development every developed many
cnnosest	city name novel originally served entire served turned
cesb	cast every such became
enhoulll	eight national head other units life league land
eaisewa	enough above interest station every wanted area
etriwd	eight title replaced issue writing developed
mwri	modern wrote role including
cepdrlh	city eight passed design result long history
segrro	sent every great right runs opening
tnann	town north added north named
elnsedp	especially lower north scored elements different positive
doetibdhl	decided often eight then including became days held later
iitec	important introduced told eventually country
iatr	instead among turned result
alvya	additional live very years across
rydren	rest year damage route ended never
dreb	down reviews ended built
caenmri	common around early near move recorded included
ermygi	enough range member young games interest
avtnain	average various those near across itself never
afes	army free eventually southern
cnid	career number into died
uunotei	usually using noted original tropical early important
eavbrc	entire areas very battle road company
geteieg	groups established three entire included earlier game
meimt	more ever included most time
iosepidr	island originally state east provided include days region
ioenoel	interest often every near office eight late
toee	troops other east evidence
toteyst	team original them especially year such thought
cotv	continued ordered tropical very
ieadhc	included eight attempt during hurricane campaign
cueafyon	control until ended album finished years originally national
elaiie	eventually land aircraft itself island election
saeeoiicr	since around ever earlier only increased initially could race
aeshbd	away earlier said highway become designed
lumi	lost units minutes instead
idriacw	international during released into almost children when
giio	groups idea interest originally
ldeo	lines decided elements other
alasd	almost level again sent down
egwa	election going whose additional
rsepoea	review section entire part others established aircraft
halvvh	high across last very very head
ecaeoe	enough construction away events open entire
sevan	signed early very area near
leepsgc	loss eight earlier passed signed goal city
dndld	decided northern directed lost decision
nmiet	near main into earlier their
dgyh	death goal young high
ealt	established according level through
evrt	especially victory released television
iside	island system including died events
tdlg	they designed lost gave
eleia	earlier lead enough included aircraft
emehnee	evidence main especially hand never established earlier
hysl	half year species least
thdtg	term history decision total general
iseua	international side early until album
lostlwtrh	level once served thought live water town remained held
tpcuh	three positive cast units house
iurt	into units round than
aieseight	according international election state east idea government have town
stomnil	soon than once match never introduced life
rotvi	reached original turned very island
ipelilmv	interest party events line include late moved very
tnnnedna	third novel novel northern entire designed noted again
enhae	entire named held about each
ameeft	away music east east featured troops
bdevc	born died event video control
ntidn	name tour including does number
tlenioeei	training located episode name increased other events enough island
ehrcl	especially highway recorded career lower
glosnmre	goal light once sound nine members review east
ecnlh	especially called novel lower have
tafd	there appeared felt directed
dianviaa	died island announced novel various into already away
