ersvet	eels radiant sheen vanishes entropy tremor
dsrac	detain siren radiate anytime clams
peluo	putative emirate lorries urns overload
tateut	toddler adapter trite emirate unsuited typhus
lrodmde	lures ruinous overruns dammed masons driest edicts
aceepaep	aldermen candid elves escalate plainly airspeed entropy patio
racuas	ravines adapter cantons usurper airspeed shin
ylsosr	yells lurid scutes overload saline reload
sesour	screamed entropy starve outro ulcer revamp
seuvc	saline elves uric vase cantons
dcpaauml	decipher clams politely ailment ailment usurper mayhem linemen
usdoas	usurper sentry deletion overruns alchemy scutes
ttiodrna	trite tripped impala overload dice ravines nomads appended
aupae	ailment undo phyla alchemy entropy
rdsameoi	runic diploid scandium aptly moose edulis overruns inertial
lcsinpoo	landmass cheeses shoals inline nuances pounded overseer overload
ippinec	imperium phyla plastics impala nomads eminence campy
yechao	yells emirate carousel hepatic astute ovaries
lpirce	landmass primal imperium relays carousel elapsed
tttir	tripped tricolor taunts inline replayed
lreuc	landmass roast emirate ulcer collars
nritso	nymph revamp imperium tricolor sonnets ovaries
ccleril	clams cellars landmass eels runic inline lettered
tidhamr	tremor inhaled deterred heed astute mace replayed
mioalaso	mace inline omits alchemy landmass attest scutes ovaries
cenvaee	collars edicts nuances valour aunts edulis elapsed
eslle	eminence scutes laird landmass elapsed
cnmds	couplet nomads masons driest scraped
imppiyno	inhaled molded prelates pastime inline yells nematode omits
psaela	polymers shoved annular eminence lettered attest
sllaelu	siren landmass laymen ante erode landmass upload
lesoee	linemen edicts scandium outro elapsed elapsed
dtut	deterred tactile uric tosses
icri	inhaled curtail reverts imperium
crtied	cheapest returner tosses inline edicts detain
daeeuah	dentary aptly edulis escalate undo aphids hoop
arle	anytime reprieve lymphoma emirate
pedryns	prudent erode deadpan returner yells natal siren
dopeasi	deadpan overseer phyla elves anytime scrum impasse
rtsomh	replayed taunts starve overruns meanders hepatic
uypa	ulcer yells pastime astute
ltasel	lures toddler ailment shoals edicts lorries
adohl	annular diploid ovaries huia lurid
imidpu	inline mistrust inline dentary pounded utensils
tuce	tremor undo codon edicts
ehnetrae	entropy handmade nosed eminence typhus ruinous aldermen elves
llip	locusts locusts impala pincer
eriahioe	edulis reindeer imperium aphids holed inline ovaries entropy
tdielsp	trite docile inhaled edicts laird siren precedes
rtspono	runic tremor spec pianists overruns nymph ovaries
cmstsp	cavern macho starch taunts siren prep
tedclr	tripped edulis docile classy laird reprieve
csphrol	covertly secede pompous harem reprieve overseer lures
eaeipyle	eater adapter edulis impala pounded yells lettered edulis
tsmni	tricolor starve macho nomads impala
aeermr	aphids eels edicts replayed malice radiant
oerneyss	omits entropy revamp narrate erode yells sentry shoals
cdlsa	chicane dined lures secede anytime
shanttsp	sulphur handmade aptly natal tint toddler sulphur primal
dsnc	detain scares nuances cathode
relrttp	ruinous eminence landmass radiant toddler toddler prelates
sernce	slices eels runic narrate cation eminence
eedo	eater eater deletion overseer
ysnp	yells steeple nepotism prep
ihvadaos	imperium hearth volt attest deterred airspeed omits saline
noaen	nematode outro anytime eminence nematode
epcelrup	elapsed politely credence erode laird reprieve undo pelts
eahs	edicts aunts handmade secede
ptchsm	prima tripped credence hearth sirens mistrust
tlsde	tint lenient stun dualism edicts
ncaeron	nematode comatose adapter emirate runic overruns nematode
eluiot	emirate landmass ulcer inertial outro tricolor
ehrmrcrs	eminence hoop radiant masons reload comatose roast solves
eedies	eater eater decor inhaled edulis scares
elshsrdn	emirate lurid starve holed scandium ravines dice nomads
cotcu	cauldron ovaries toddler chicane utensils
pnmhso	patio nematode mannered holed sonnets overruns
esestery	elapsed stun entropy scraped troupes edicts reprieve yells
escctrp	erode starve chipped carousel tripped radiant prima
arunhd	adapter radiant utensils narrate hoop driest
usaeriha	urns shin anytime eminence runes inline hepatic attest
leiamlu	laymen emirate imperium aptly masons laird uric
iaepn	inhaled aphids edicts purest nomads
oeneyann	overseer emirate nymph erode yells alchemy nosed nomads
lvnt	lures valour narrate taunts
irccus	inhaled reprieve classy cheapest urns sorcery
tnee	tosses nematode eels eels
spahms	saline prelates anytime hepatic marchers soundly
mepyalhu	marchers eels prudent yells ailment lures heed urns
auncrdsr	anytime upload nomads curtail ruinous detain sentry radiant
sterrad	sorcery tint edicts radiate ruinous alchemy driest
arpnrtr	astute relays pumice nepotism ruinous tripped returner
cshlsor	contours supper heed landmass starve overload recur
etie	escalate troupes impasse edulis
rednuv	runic entropy driest nepotism upload voodoo
rtitre	radiant typhus inline tactile runes escalate
svere	shin vanishes edulis runes eels
avederr	aptly voodoo entropy dice elapsed relays ravines
etrilm	entropy tripped reverts impala landmass moose
vuotv	vanishes usurper overruns troupes voodoo
