ersvet	eisn rmydelo strne vonnaeie eaaprhr thetss
dsrac	deetns smria rilayea aiamtne cdtni
peluo	poiermde eaoitet luilsvr uanv osrrtera
tateut	tsidpdt apeetie teras emenuar utydhdrl trituo
lrodmde	lssrs rdanrsn oavmstud deumnc mieouo dssuie ererti
aceepaep	aesdriae cetpde ellel eairsnan pdcotsn avylrmpo eidniea ptaly
racuas	rniraph aotssra ctdpirv uesnair aenpduee sesn
ylsosr	yeoau lelil selnts oidadees soluld rrarcv
sesour	suvtrrrr ercypem stadee ocnoo uvale ratemp
seuvc	sasscn earei uasi vllt ceennvo
dcpaauml	dmcrelee ciesp pstiaepm aratnoe amieryh ueietim mulnln lhynllm
usdoas	ureeury ssitee dlprnuum ontsrloc aeevesy scrthn
ttiodrna	tpsve tidsner imrdot odenpede dedr rcovmap nlalai apieaipa
aupae	apitmtd unyh penym allroey eoanhlc
rdsameoi	rvlus dnulrut sloriiun acsrc mseyo eteddo oeinpdli imniaapi
lcsinpoo	lsdeeuoe caannds srolee ihcuns nmeanis prnehlr ooaveesl oseavsdd
ippinec	imsmmenh paats ppasmply imaecp nlramc eueialin cdyoi
yechao	yetas eloiclm ctereuia hvuestr atpasi oeeaslr
lpirce	ledusmeo pssaps iialadua rylrnm cpmaeser erailml
tttir	toeocyr terndtnl tiapei ipsler rlpudani
lreuc	latstlls rocld emesraa uarms crionea
nritso	normr rpsies inrevaho tvcamnoe sepmtii orpuylm
ccleril	crliu claenld lemllsne encn rdets ieitaa lrsmsesa
tidhamr	trcnel ierdder dteteeet hadu admaoe merl reahyeps
mioalaso	mvti itrhna ostsa acmmsiy leenndse auatle semstc olsciea
cenvaee	curanua eusaad npccsss vtelon aeoii etldll erslsud
eslle	eandlima ssncsr latae lmsspnee edecudi
cnmds	coeltsa nrsaoi mrcust dmpeae sdnospd
imppiyno	imaiade mleome plrissts poaelda itlhen ydedn ntieeesn oltlm
psaela	penvtrno seliet aetdeds enteymus lhmtralo arence
sllaelu	seeod lmtydmaa lnoenp anse ennsd laramdla usiasr
lesoee	luicaap euadie ssdnenec opide eldttmr ensolms
dtut	dalectrc tseiisr udro teseet
icri	iuhmvsl cnpdtlt rriaumi iraereee
crtied	caeeoapi rsecinet tletun istsrs etdshe dinern
daeeuah	dasdacs aylyp etttoo eonupler unhe adsipa hldi
arle	arihyeo repetmem lvetaynr eapiimm
pedryns	peurenr euaet daoarrd redrient yeepd nnlsa sntll
dopeasi	drrevea oslcdess penee elryp aansaua svyti ihpmemm
rtsomh	rerveute tetpda sesneu oecrarad manpanrs hytlsiv
uypa	uects yiert pslltem aelusa
ltasel	ledlr tstrrdo aiomids seleoa esrehu lnlcits
adohl	alrvsnd diipaai oueloiu hida lrurn
imidpu	inltet malsroed iniytn dinesds pilnusr unteuien
tuce	tersdo ucni ctrnd edooom
ehnetrae	esvoeel hnyroumu nesea etsnsuee tdynnd ripnmpl aeariomh edcdn
llip	lcampau lccssss itnreu piolot
eriahioe	enseiu reeinoai iilpedtr aimesd hpohr isyern odvpumr eilelnd
tdielsp	ttlec dnicdo ildciid eereeh lrrse sndrs peiiaeat
rtspono	rnaiu tovytr srec pesnhpnp ommrsiei nsiev orcrsau
cmstsp	cvrras muocn shenpa tnriee sarch ptat
tedclr	tirdeli eesuli dyseip cpiaer lvpao rdsedcrl
csphrol	creeyser sraoep peveeme hrutr rcrimodp oveesulv lseoe
eaeipyle	ereud aelsasi edasod iuader ppnidet yteet letuplll emaldr
tsmni	thasvadr smolor mpmao nercaa itlcio
aeermr	ascisd ehie etdsle rayedild mtlaia racpnpe
oerneyss	oanll erernpv raomro neyamhy eoeei yptlt ssrert stsdsa
cdlsa	cemeran dieye leihu sdseet acndcni
shanttsp	sorpead hlnlnuet aadlh ndtar tuip tudalmp srlmuyl phtira
dsnc	dereci stnuat nheacan csdoesa
relrttp	ranasdl etonoaen lredotmi rieeees tndilrr tausdcm palnsudd
sernce	snircs eaai renim ncleent crscni eoeelaut
eedo	eeeei eeeat dsravnot orerretl
ysnp	ypple seeeois nrstlmtp plee
ihvadaos	ietdieed hmlotl vett atsahi dpeeremu aesierpr onria strtms
noaen	nnmncnmm oteie addrtat eeooemee niyeotua
epcelrup	eepeyia peclrivo ctderdad eorte lipre reeessno uedn pdlll
eahs	easuen aedtn htddaedi smscec
ptchsm	pirar thasrei cmeirsrd hedctu setspn meeniptr
tlsde	tils lnseuum stia dtnditn ecietn
ncaeron	ndrutntm croesems aoaaoet etecrad rmami oneereip nedovtau
eluiot	ersetta lcioruas urdae irclotor onmni traelmil
ehrmrcrs	esadoton hvmo rallooi mtaesp renads csmaonat rneec sosieo
eedies	ehrte eeure dasao icceatd ealesr sdlrni
elshsrdn	evaurmv lciin slaaiu hdsoa srttdcme rreieea dsin ndmoed
cotcu	cnirntll odcleue taosore ciniers usahdavd
pnmhso	paduv nsretono mlieoend hadem snttroe oaesrenn
esestery	etdapne sssl eepvpds spespui turnrir eceeot recdyaet yorll
escctrp	eepla striid chaeuoa civrnrre tioetds rppdapm pdare
arunhd	araeirs rstoraa utendtai nepdnla hstr doitpe
usaeriha	uiee srni anumhip eemisate retyn insnei hscttec antnnl
leiamlu	lmmlro eaypiem inaupstd aiyrs mrarca lieem unti
iaepn	iacesrd athdus ednilh psdtmp niaseo
oeneyann	osmdesrh ecesald nesoh ermyr ydmpv aymltee nirel noeaeo
lvnt	laorr vteusn nauatru tresal
irccus	iprlaae rseeehro clipav csydthen uyrn sceerss
tnee	tsasoe nemledte esse eols
spahms	snteel ppiatoia aemleun hayhcnr myesstia sclrdre
mepyalhu	mhldrtms esue peeleil ylrne aaeussr ltrec hens udnr
auncrdsr	atnpitr uylyao nutmnm cdusiit renaduo dnnaas sateae rilrdoi
sterrad	sniherr tmts eeayld riurcsy rocttnc aiisdei dteoua
arpnrtr	aonete ruempi prnsee ntosrice ruepdau tiusrmy rsutitlp
cshlsor	cddpnuee srolma hpvv lnsadrat sesctr oaoreeur rsueo
etie	euatipss teocrad iapllss emsuee
rednuv	ruone elpmsri drooet nipntoas uoycoo vtpdid
rtitre	ratneec tlyhil iauans tiepeaa rnsnl ettdcuis
svere	shss vnshsian eeslel ruued eiin
avederr	aptyo vepopo elynnyl ddsa eseisoo rireca ratevdl
etrilm	esinptn tparaam ropvdeo iledme lesorasy mtrsp
vuotv	vsinrhou uoerssn osrsdoev trueoau voprep
