wtesnnat	warmth target expects systematically narrowest novels adhesive trombone
invceirin	inertial nationalities villain credit enroll inevitable rebranded ionic nurses
htlaq	hunted timeframe lapse appreciating quark
saonirh	steamers airline overcast noun intensively relayed hoist
icaitnap	irritation chairmanship archaeologists incidents tight nova attachments patrols
pweiop	prospectors wacky exaggerated irresistible orbs parting
aoehhloecr	activated overcrowding eighteen hexagonal happen lady obscured elevating copies rolled
eilmhv	expire itinerant laptop methane honorific vinegar
oedsttt	oxidized extensive deified strategic transferring troop type
sbepent	subconscious budgets estimating persists erstwhile nuisance throwaway
lirale	launchers inhibits revolve argon linguistics enthroned
iigrooenuu	interpretations innings gradual restructuring organist offset experiences numbers unofficial unconvincing
nnlgtbsebsa	nowadays native lecturer guaranteeing trail bequest servicemen ethos backstory succeed aligning
opna	opportunistic pores nominally arable
ihiltr	inability hotel induced longtime tracks rentals
ryddvic	regimen youngsters detachments disobeyed vertebrae indebted constraints
eaeensi	embellished authorize educational emirate navigational slogans industrialist
tided	took improperly delegations expatriate drafted
iessincsil	intriguing extinct separation subtropical irregular noticing condominium sponsor identical lakes
raissgla	rumors arms intensification subgenre spindle genera lies advocate
neer	nematode electrodes emulate remedy
ebirsl	entail butterflies investigates rocker scaffolding lots
jyoteru	janitor yearning operational tracked exports rehearsed unfair
yeraspuclnni	yearbook extracts religiously amino stereotype parapet unarmed conception logistics nominations neck inhibited
eecdecsut	express extremely cold diversion existence crab sentimental unauthorized turns
uuramerao	undoubtedly unsuitable retiring ancestry modest electrode renumbering applying outfield
soerdue	stewardship owned equilibrium republished duchy unacceptable elevating
areiannjenc	apprenticed ravine excused imitated admit nominations neat jackets evolved neutralize conferences
nbdaen	nasal bony developments admitted everywhere northeastward
intiemyto	important narrowest traffic inedible enhancements molded yearbook tapped outbreak
isoaeeid	inhabitants separates officials agenda evolve encountering interpret dissolving
sisrrsoopos	style instinct steamer rewarding ramps sponsor obnoxious observes prophets overlooking signings
yliteslgu	yoga lovely identifiable tongue eagles spent legged grove unaltered
talntn	trains antiquarian lifeboats nursery tricked neurotransmitter
nreaiesn	nature rocks energy aggregator intern enquiry sprayed northeastern
eeirirouht	effortless elegant insulation ratified impending rhetorical observation ultra hypothetical toads
aptiatld	albeit pious teammates incoming attackers transfer lanes detachments
aieptuhcto	arguably inflorescences epicenter parameter thorns unhappiness hypnotic contrast textiles offerings
timsepia	trapped imply mitigate softer endeavors persuades infinite arena
tnytidyb	twinned northeast yuan tropes invitation distinguishable yelling bucket
igbvcsesep	investigation grave bricks various combo scenarios experimenting stunned embassies passed
songans	smooth overcrowded neon graphical alleges nomenclature shallow
tpoahmvir	tweeted pneumatic ordeal awkwardly heroic memorandum vest irrespective roadways
onsryil	officials necessitated synthesis resuming yields initiatives locusts
acdrneswr	accurately crowd disbanding reprint noblemen emplacement study wind repatriated
dnen	departs name emergency neutron
cbeyor	crows breakaway error youngster organisations raging
cyho	confessions ytterbium head organs
peirpsp	parasites enhance injected railways parenting swift patriots
nskcerliel	newfound saga knots convenient everybody republicanism livelihood issues easiest laden
ntdgjragmc	nanny technique disarray governess joined retire assigned grasshoppers milder covering
eaii	expert areas interdiction integrate
mrsdtnwanoe	mythology revolt seats discrimination themselves neared worst acquisitions negligence office essential
aeucsy	antimony endeavors under cured seminar youngster
otna	operatic traders narrates arias
mfuerruuti	minigame fragmented unincorporated embryo restitution repertoire underwent ubiquitous tutelage interpreter
deht	dismissals enforcing hexagonal trains
efreatnt	edicts forefront repeated exposed annexed tribe nationalistic throwaway
edanc	electrolysis divergent amounting nucleic commence
rcfuea	rendered californium fabricated unreliable enterprises albatross
ialjpmngcnu	infer anarchists labyrinth juniors pelican moment node generation challenger noses usurped
oaptoterli	ours adviser plugs talents overruns tricks enclosing relocation laser incomplete
rculpsael	requesting concealment unprepared ladder packed slim accumulates exists lyrics
srents	string recorders excludes newcomer trek statement
tanolocth	trail anticipation narrate ourselves landscape ordinarily consternation tightly hyperbolic
sbiemo	speeding bathtub intact eternal masterpiece owning
eltotersr	editions left teenagers oxidation teaching equipment replicating southwards realized
snrtmospta	serves narrows rams testified mitigate organize sulfuric pleasantly trainer attractions
ehtoagop	evergreen header truly offline attic gliding oxidized prosecutor
iseitlt	inspirations spontaneously envy investigates terrific launches therefore
tdcae	thrills dismantling capacities acquisitions electrodes
ioradrv	imagined opponent rustic astern deduces reproduction vertex
rlnneyb	retailer live narration northwards expired youth bright
nget	neared gaps elevating that
iriokyrnta	investigators retaliatory internally ourselves kosher yard raises nominations teammates admiral
eessminim	exhibit exoplanets sixty southbound mammals isolated named implementation measured
lanco	lava adversary neighboring countershading overlap
rdsahsvnc	retrieve deforestation southeastern audit honey startup vanguard netted capture
nnasdle	negotiating normally aptitude stock denote languages entitled
rarsr	respite alluding recorded styles reeds
toplsstet	territories oxidative parenting length stickers suitability trailers encouragement theories
iaeewdkasri	infested amnesia exploding eggs wheelbase decisive knowing annoying scares resigned imperative
rrtds	relief recognise tending detonated seems
aoaidtaoe	anterior officers archbishopric inaccuracies discomfort trip across ornamental enigmatic
siitch	silver inventor intuition taller commands highway
cardsk	challenging affirmed resisted domestically sportswriter keyboard
escdaet	exiles socks cultured dissatisfied automatically extend trying
aoooaymapiicpr	activated orthography operationally overfishing animator yelled monster algorithm pizza individualism invest compared particular recessive
hlvarprsi	hazardous lore velocities arrayed ruler physiological robins schedules initiated
hooegrssi	humidity opportunity optimism electrification gambling runaway solo searching insensitive
crrdft	cores regular racetrack domestically fewer traction
fioudm	funk invaluable overarching upgraded dramatically motivate
neuvem	nativity enlist undertaken vulgar elaborate manufacturer
ptli	pieces testified launched inspecting
atekss	amplification troubles embroidered knock starling scant
iuasgleairs	infusion upriver arrays stereo graduates limits extent activates incidentally revenge sticky
titrlsn	toddler integral tourists referred loads sudden northbound
saidrdistaha	sanity advancements indicator districts remainder dissimilar injections skaters towel angular horned asserts
pokolaasanitpe	prestige organizer knocked opposes letter aerial appease slower attention nonetheless imaginative theatres pitted exposed
ghrsaioms	girlfriends hint revolves sprint asserted instinctive owners movements swelled
vagaid	vice afford graphically alternately intuitive defied
risicdud	receiving incisive sabotage isotope congestion doubled uneventful deliberation
sntlaeleb	surge nearest trick lodge anonymously evaluate lasers engineering broadcasters
smtcuili	sleeper milligrams taunting charged unrest influencing loves innings
plneosib	presumption leanings notify europium outpost shadow impromptu buffer
ypstaeta	yielded primates sect tapes aired equalised thoroughly accusing
ieodyl	insecurity eastwards only dwelling yielding lunch
gaogeidrppeo	germ adept overheard guarantee extended inch deadline reflect preface percentages epitome objections
oooannrssp	others offseason oppose anthropologists navigate notched researchers sturgeon suffix pointless
dasieipmoopvc	devising appeal statistic industrialist experimentally intrinsic pupil midfield overpowered orderly portal verdict capable
tptiin	traumatic phone thrill inconvenient intriguing novelty
nsfuoll	nested satellites floated unexpectedly output labelled lays
nadsi	nevertheless alligator dwell suzerainty intersected
panbihc	primacy abducted negotiator berkelium initiating hands ceremony
rheuetermarsen	returner hare exponent unruly ensemble therapeutic emergencies ratio merry achieved resigned seminars elastic noticeably
aoegdn	academically obstacle echelon girder demolishing noblemen
tsytir	tandem supergroup yacht thriving intercut refining
gnrtegt	generate necessary riding tearful easing greenhouse tunnel
ntcygtvdhg	nonsense totalling complicity yard generator transmitter versatility defunct humour gubernatorial
teiscppt	turned extradition immense skepticism consist primitive payment titanium
