ydeusl	yield disco evacuate unhappy sitcom locals
uemdt	unrest editors miners dances tier
lydre	lots yield develops remnant editors
atnsco	advisory trout nurse slot commands onset
priaaes	peers riots invested advisory assured entries statues
ssuieiae	scripts strictly unhappy inter ensured innocent auction editors
actcdn	anchored catches tends clause depot nucleus
lcyrlo	leased careers yield recalls lecture odds
trceno	tailed recruit corn employ nerve overlap
ctesa	chaos tidal enclosed saint advisory
uanrovts	unity aliens narrator rises odds viruses trenches spur
puesre	prone unity erupted statues routed entirety
peadstdu	pioneer everyday array disco servant trenches depot unrest
srsnr	scripts revenues surveys nerve rises
aspreseu	ancestry shirts plastic reply emotion sounded ensured unrest
taaderhn	tailed aliens amounted dancer entity routed horn nurse
psaretl	persona sued anchor ramp emotion torture lectures
emiuer	entries mount impacted unrest endemic ruined
elradr	ears lectures resume amounted drops ramp
dnenc	deleted narrator entries nominee cream
thrle	tends heated resist lectures entity
tlvetp	thrust leather viral editors trace pioneer
oehrese	odds emotion happens rises evacuate servant enclosed
psiuren	punt stomach insect unhappy ramp editors nerve
rrhsapmu	routed reactor hate shooter appoint photos mount unity
edrsuii	entity devised riots stranded unity indirect iconic
ipvav	immune phases virtual aims variants
oecue	overtime ears clever unity employ
terrcnts	trails entries resist rituals criteria nurse thrust servant
rasryn	rituals anchor saves recall yield neutron
eiriesl	editors impacted riots impacted entirety slopes lunch
apactr	authored promises anchor calendar trout reddish
oath	onset accepts throat honest
ocev	odds calm endemic viruses
euuuoh	employ unrest unity unhappy opener hyphae
odoacee	odds disco overtime activist convoys enclosed endemic
pemy	promptly employ maternal yield
eithihe	entries invested trails harder inter humorous entries
scernoi	spans calm entirety recruit nominee outlets invested
napale	narrator ancestor pioneer appoint leased endemic
nptd	nerve particle triumph depends
cdanlr	contacts deleted alumni narrator lecture rode
cpeaa	calendar patch everyday assured acute
eevaar	endemic evacuate vacant authored array rope
yehe	yield endemic hell editors
eeheeaeu	enclosed erupted hyphae enclosed endemic alert entirety unhappy
tirs	tired innocent reunited secular
unyyrmee	unhappy nucleus yield yield ruined median evacuate ensured
ulcloop	unity locals chaos lord outlets outlets purely
ylropeo	yield loses rats onset purple editors overlap
pisesr	promptly invested soccer erupted scripts rises
dayilp	deadline alter yield impacted leased purely
eltlchd	emotion loses triumph lecture creators hiatus divorced
udnaehts	unity detect neutron amino enclosed honest trout steal
seenl	slope entity editors nucleus lauded
tamssm	tender alter medley slot spore manor
avccceat	authored viruses counts criteria caps emotion appoint trace
apmce	array promises median crushed erupted
edrarnin	enclosed disco rope advisory reactor nurse interim nerve
ectc	enclosed convoys thermal captive
ouoloio	odds unhappy overlap lecture onset insect outlets
trcdeo	tier rituals corn deleted enclosed opener
elsi	evacuate lion shirts immune
uott	unhappy outlets trails touched
sendemeu	secular emotion narrator demon erupted manned entity unity
rttcs	recall tailed thrust cloth schemes
ortcaire	odds rope tender corners adoption insect reunited employ
crdo	counts ramp depict opener
tressm	trenches reply entries stomach sharply memoirs
rrthd	recall ramp tailed happens deadline
rhahopl	relieve harder adoption hardly odds promises lion
sipaad	strictly immune proven ancestry amid demon
ipsietle	innocent platoon shipyard innocent entity tales lecture enclosed
appocl	array persona priests onset crushed lots
evraisdn	evacuate viral routed array isotopes shipyard depot neutron
erspi	employ rituals shoots plots innocent
drsnmo	depends ruined spore narrator median onset
teocutoe	trace employ overlap criteria unrest tier opener enclosed
ssedsvm	stunt sitcom editors deleted statues variants medley
iirdem	indirect insect reactor diesel emotion manual
dnpccnsr	devised nerve proven calm convoys nurse soccer ruined
imenurr	interim miners everyday narrator unrest realism revenues
ednai	entity devised neutron acute invested
stitlspt	strictly touched impacted tailed lectures strictly purple tiny
hlps	hate lauded planted seasonal
nclhaa	nurse catches lord harder ancestry authored
paul	pyramid alter unhappy leather
aescns	aims employ sends crushed nerve slope
oeauspyc	overtime editors aims unrest spur premise yield crushed
lviilsdt	loves viral indirect immune lunch spectrum disco trenches
ahosers	amounted hell overlap shirts editors reddish summoned
proltlp	priests reopened outlets lion traces loses pinned
ieptemo	innocent employ plastic torture everyday melodies odds
hlan	hectares lemur amino neutron
alslam	array loses starter leased amid mortar
enltel	erupted nucleus larvae tears evacuate leather
hmmps	honest mineral meantime portrays senator
lsrlrrn	lectures seated rituals lauded reacted rope nucleus
lsmsed	lunch sounded manual sharply ensured dancer
siiec	silence immune induced ensured clever
