tpiurili	strips spurred diagram outs orogeny nineteenth flame airstrikes
etlalpnol	segments attractions aluminum capsized alternating spent enlists robot clashing
aidie	manuscripts vitamins advances lily tests
phlorss	upheld shutout alerting hospitalization arose ascribed assistants
pttnmnoa	open strata attachments underdog impeachment intercity courtesy mainline
esstde	deserved ascribed estimating stability adjutant verge
mepliiinng	impassable temperament spontaneity alters fireman discord given insects uncle agriculture
pgcedt	specify agriculture accuses benchmark ideology stages
sneartd	asking unexpected medalist called traversing strap admirer
perprnr	sprawling letter wrote apparently growers unaware arming
ytntoe	types stays inserted stud convoy debtors
eoplvlesda	sealing compassionate speakers blasting overboard cleansing perilous useful idealistic rankings
iipoyatgeel	kickoff figured opining docile symbolically namesake utopian agriculture detonating reinforcement altarpiece
naoo	enable paddy nocturnal movie
ccklou	scanned occurring skull classified dock ludicrous
utneoud	nucleotides attributes antagonistic vending polluted pups advocated
onteopi	colossal anytime strive designate coaches approaching wield
edomd	beauty additive coping emissary adequately
ennanrtvsr	reorganized intricately institute galley interfaces arduous ethics overfishing established crowns
rlnasert	trading plundered android walking assurance tells preference starred
csht	economy assessing thickness strongest
yrskga	symphony profound establishing skilful iguana facing
gpgrore	ugly speak agony proportions positive president testified
uignselyenai	futility list agricultural unsettled assemblies recited slap tyranny geographically index painted rises
aelpaomoi	batting beats closing applying cafeteria competitive smugglers collective mission
haeciotra	whaling matched realistic accessibility fields doing statesman drinking magician
atsiels	battle staffed associations richly retrieves flashes issues
uueuhissnni	supergroup rulings perimeter authoritative cheeses eight islands association annexed anticipation nightmares
ineoop	civilian ensured relocating sons colonists spine
bmfarafls	obvious ambient effortless cartoons protruding lamented offender else assembling
hpotptno	character upbringing locomotive statistical aptitude strikeouts annular tourist
teesnnnipih	staffs denotes terribly assurance angering environments snapping dissident spilled virtue theme
sisncltio	aspiring direction ashes inserted accordance cleansing station cited bookstore
anrssa	faked anxious brief astrology espionage career
epesssas	devise aptly heats associated escalating escalators backbone psychologists
tdainirrnr	study adhesive camouflage liberating inert midshipman brave arrows unconditional problems
eecsiirr	rectangular gears scientist escort viable circumstantial trunk gradually
nslltharso	induce essentially claimants floods attending shops marry breeds astrology commission
rdvpnles	prints advertising aviator opaque unnecessarily plot relevant assume
eaocmslt	dens haunted soloists screen embarrassment escalators illustration standby
yoepudryaa	cyclists noted declined applications sublime admires princely dysfunctional haste hatch
dsacrdc	identifiable esteemed caravans accidental drains editors accuracy
dlaopsmhc	idea electronica barefoot monitoring optimum osmium employ thrush acknowledge
oiahesh	cost microscopic matured shortages peat astern shortlist
ilvrueptj	rivalries plaza avoidance bright audit seabirds appointing stipulation fjord
sdrc	ascertain admit grateful scratches
nobain	interrupts countering obsession party livestock uncle
nree	knights professionally perched performances
doegito	identities noblemen peninsula ignited literate stitches booths
uraeaiseva	burdened trainees valence reform tangible rivers ashamed section overcrowding halfway
ioobawiyri	finest tollway formalized abundant tawny sweetness liners hydrogen preschool miracles
tost	stealing towers astronomer strengthen
coesattsroi	scores forbids penalties psyche wading steamboat utensils ascribed present nose airfield
oolnto	dozens contested claimant unwittingly steaming posits
rrip	pretty principles limestone specifics
leornksntg	flex resignations torque transporting enabled skip ascetic intervened striking agenda
tcdi	sticks echoes ideologies timetable
hubsdpne	whimsical pulled abolishing assessed adherence upbeat unconnected yelled
ototi	community stationary posed stuffed hillside
gigioc	aggregation citation aggravated widened correlation octaves
sdsmliunhpt	assigned adept islands emigrants plains disappointment publication inaugural threat operations status
icssreeeis	discipline sculpted psyche assimilated presidential retrieved revelation versions minimized assured
eiistsstt	recess riot first assert attempting assailants ascendancy statistics stare
gdidhr	agriculture advantageous distilled adjourned thinner crude
tyglonbin	stressful hydroelectric agencies flipped southernmost entered abbey yield innovations
cealtk	accused reintroduced manuals glazed stationary skin
alaaensar	baggage pleaded labelling jail declined endorsement psychology tapping trot
cndntbvpvi	scale ensures advisers environment startling observed overheard ephemeral oversees cinemas
ffiooeic	afterwards offices dissident consequent compassion repressed pitchers scholar
yyvihiu	cyber mycelium average distrust these bind suspect
essit	version issuance asphalt hilltop streamed
rciyien	protruding scarce circulation mycelia nitrogen heats inspiration
wdttryi	swampy adjustment strongholds steamboat bribes typically pillar
edhu	leftover adorable chronicles junk
tmotetebea	striking empowerment collapsing starred retainers structurally reactions observations retirement earmarked
nawcvddsd	interchanges haste swords accuse overlapped adherence identity asleep adjust
dnoga	advantages undo composite aging hazardous
rtjtapobm	protruding stereotypes eject strip mates spontaneously forgiveness absorb improvise
aamnkau	rainforests fascinated embracing intermediate skits sake bullets
irrie	virtually credits tribes picket reflexes
ndaorrsii	enchanted adjustment mares pounded ordained erstwhile aspirations limb birth
sdavtteeyic	assessments admits wallpaper overflowing stigma attested resuming reacts symbolize bind action
aprha	pays specialty progress whereas baptism
rtaseitte	tractor atrocities lasted islands reliability rival strengthening still recuperate
iaceur	pillars cavalry sculpture separating functional troubles
dehitt	edged feud whimsical civilisation attaining sticking
iyrjsde	midshipmen mystical dragged eject escorted address rebelled
ietsaserrasepn	simulating selfless strangled assigning raucous assaulting redshift proof crowd ballcourt estuary decimated spores inwards
esificewl	rehabilitation aspiration millennium affiliate lighten scarlet verdict swine glide
sublrrlep	especially outbreaks observer slender arenas practise gloves teens spouse
irayem	piston crevices magical bypassing seclusion smiles
nairns	intakes laymen mixer cried innovation ascendancy
tgbhme	utilitarian eggs above thus imperial selectively
aasi	earmarked parachute assimilation financing
dgeton	additive ages pets stallion locked encamped
aiivyihuuog	ballet figurine viewed avoidance lyrically discretionary whales durable numbering poll igneous
nllsoes	individualism clergymen flies assigns confer ceased escalating
sdpjarqaeofi	assert ideas upcoming eject causes writer squirrel warmed vested done offseason fission
mnacaaagbsasme	embarrassing insufficient lacking screened haze battery macho aggregates obligation assorted cameraman estimated amongst beaked
nmroelkee	inhibit imbued orchestrated comic persuasive alderman skin responsibility recommendation
ousisl	sounding fumbled estimates limp aspect alleged
nnloantr	interceptions unseen elevator hook banking understandable athletics prerogative
nsieugonc	inconclusive assumes tilted description outside ignoring borders underneath acclaim
amadoctt	cadet amazing warm adversely bolstered accessed stuck staunch
ebdaitrr	tears ibis editors massed timid stormed originates precise
rslntpsc	aristocrat asset clerk incremental attic apiece escalated scarf
iheeri	dinner rhetorical weather reboot erstwhile disguise
rupirwttcedi	greatly bubble speakers pigeon breakthrough swap standards strove scenarios pesos adversely viable
eiysecepeo	desk withdrew types assent peacekeepers sculpted terms spray beautifully downturn
smetnctgrpnap	psyche umpire rejected attire unaffected schoolchildren styles aggregated dreamed upgrades inshore patterns apples
pcrden	apprenticeship echo promoter ideologies generating infringed
sergtaa	assaulted reflecting drivers ignite stigma handing fastball
ptcln	sponsoring statewide scratched bloom internally
aeenria	parents metamorphosis reviewing anarchists promoting dichotomy caring
atrahrrildgano	management stimulation crabs maturation checks transcribed wrestling disc plazas adept agitation yarn uninjured northeastern
ectlce	teak scan attraction electronics sculptures repaid
ainesu	rammed discovers intriguing genres associated autopilot
nrbyses	encourage trial abbot symbols osmium reported osmium
hlamttisma	sheriff slang last impaled steering strengths tilted usurped emigrate sales
tuvsttic	starving bulls evidenced established otters utterly ninety schemes
