studio	storm title until days involved only
third	them have included role does
ships	species history island process series
states	special times also total event series
special	seen positive earlier come island area line
returned	remained every team upon reported national earlier directed
little	lead instead then this located entire
church	church hours under returned church home
mother	many other that held elements reported
named	noted around main elements died
received	reported either control east into video early death
common	central once most most over nine
elements	even lines events must ever named then soon
style	some third year less early
military	match island late interest tropical around released years
involved	include northern various once line video even decided
include	island national career live under death ever
events	each version even name those seen
island	included started local another near despite
north	near others road tour human
scene	served common either nine elements
scored	still career open rather each decided
reached	road events areas close house ended directed
million	minutes involved less less include only nine
provided	present return order version include days even director
critics	city runs included them instead country studio
three	than home record ended east
chart	company have also remained turned
tropical	term rest ordered produced involved command area later
rather	replaced across third hours earlier return
company	chart outside must positive areas named years
points	praised only instead name turned studio
less	line elements spent sold
live	line instead very earlier
entire	each national their instead road entire
century	command east north told under return year
said	since addition include decided
episode	elements placed included since open died early
species	small popular east city include elements season
caused	century army until served elements directed
name	noted appeared military earlier
played	part level areas year each died
areas	addition replaced every added such
action	area century these include once nine
tour	three other used received
released	road even love events around stated early directed
lost	lines only series these
director	directed instead road either created term only rest
earlier	east attempt returned located instead ended rather
outside	order until troops season involved despite entire
period	process either return into order days
passed	player army station sound earlier decided
minutes	many into national under term each started
children	century head island least directed road episode nine
early	earlier also replaced live years
modern	must open death each route north
appeared	action player party ever almost race episode decided
level	live even victory event list
southern	seven others under troops held episode received named
then	this help even never
similar	sound involved month island land also replaced
second	southern events caused once named director
died	despite include even died
post	points order small team
recorded	return entire country once rest decided each died
total	title once they areas less
reported	road ended placed others replaced tour earlier despite
sold	seven open line death
almost	addition lost must outside school they
route	return over units three earlier
created	class record event action three earlier death
opened	open player ended nine event directed
directed	despite involved reported elements cast three ever days
career	could areas runs episode either reported
addition	addition days days include they involved opened national
could	company once used line directed
either	each involved then human each release
produced	popular received over despite under created every decided
process	points road once country ever spent such
others	outside tour history each runs section
remained	replaced even million almost included nine ended death
various	version area released include others used sent
spent	scene process east nine these
interest	included national told early returned even such this
love	live only video episode
placed	popular lead appeared cast elements director
site	special island time episode
across	also children record order such short
replaced	replaced event placed lead also critics each died
positive	praised ordered sent island title included victory elements
attempt	also there troops ever months previous these
support	since until people position only released there
praised	played release addition into same even director
even	either version ended northern
school	scene cast human outside open lost
should	such held once until level decided
later	little another turned each route
instead	instead northern stated troops east addition died
people	parts events open play lines event
since	ships into never class episode
