oilres	over island little reported every such
ynoue	year name ordered upon early
tcevd	title called elements various decided
ivhroi	include version have record over instead
srtsuns	sold rather this station upon name such
erddauyt	entire released directed director another units year those
piacle	positive involved across caused late every
rapdmr	remained attempt present directed month road
mcacho	million called across command human once
plppm	provided located period play modern
rlteucav	received level total ever until came army victory
iussee	interest units support south entire east
eacsrver	elements another career season route very ended release
oahis	open army house interest similar
adrrlspc	army despite reported recorded list scene play close
tcenhssp	those created east north human site sold process
aevacda	added entire various army career does another
hoduii	heavy once decided under instead included
pptatr	period provided total area title runs
udpno	used despite party named ordered
aoint	almost once instead noted times
nrtpme	never runs times previous miles event
deynvle	despite ever years northern very located ended
trlmdpe	three role last million death provided either
moecuuet	million others elements cast used under either that
etniclr	event that never island called lost route
yssni	years story south northern into
ciysp	come included years state passed
peehrdro	previous earlier elements human return despite result only
iuadta	interest under army days time action
tmtupsi	times music turned used passed studio instead
hhuems	house heavy under every modern started
errr	ended route rather recorded
hlpe	help lost point ended
epecae	early process elements class across east
erosnss	elements rather once south noted scene soon
lerr	list early remained race
tmaeedh	there move across east each does history
rlsirdc	record last storm instead received does church
aidoio	added include director others into order
nsvo	named still various over
rieter	recorded into events this event reached
oacer	order also century entire reported
usdesc	until station death even state career
ehey	either hours elements years
auesrsae	army until earlier started record still around even
rsen	result sold elements name
depnhslm	death east popular nine history should live moved
eoshnlp	every open should house northern list play
oeauthn	outside entire also until than held nine
lutrsm	lines units third remained start many
dcyite	death come years interest team ended
oocpsee	open open came produced state earlier elements
aaacnltd	almost attempt almost created never lead term does
oiset	other include side either times
auasla	areas until army seven lost army
teneilrd	turned ended noted either interest late reached died
spseo	support player special ended other
ensaasee	event name south attempt around ship ever entire
tery	tropical early replaced years
aauaere	almost appeared units army east runs event
aolsdt	attempt open local southern died third
rrnl	result role never local
dnce	directed northern control events
edrtacrp	either directed rest term addition came received praised
ohpal	order human position area lead
aiciuvis	appeared island control involved under various included similar
dott	death others team title
hrdsac	held role death ships appeared class
epttr	ended players term than role
sysrlls	sound year story reported located last several
attale	areas tropical these almost little east
sppolmpr	site produced player outside level move people reported
etpmor	ever their parts music over reached
iielcedt	interest island even level children east death told
ulecp	under last early created party
vaecne	very added east come name early
cirimlap	command island replaced interest music less almost point
monrera	military outside national reported every replaced appeared
ssdple	started station directed play located event
lolceldi	love only list came events land decided interest
oosleeh	order over southern list elements entire history
sslst	school seven local stated time
huolpeae	held used other lines parts each across ever
asdc	addition south decided called
srsean	service received station east addition never
allu	added late live until
trapyh	title road across played year human
mslnredn	mother soon level name race episode director northern
itimveee	into then instead million very episode east east
iuicpcm	involved upon instead company placed class miles
nsulhne	north ship units less heavy name episode
ureyceo	units release even years control every opened
tnrn	turned national remained noted
rurisc	return under rest include system company
ntieee	name team island events ended elements
ctrtn	court there rather there named
remsaar	runs each much short another action reached
otecen	ordered term earlier come each north
laess	late almost earlier school system
