million	minutes increased lead lost international open northern
itself	interest time sent established leading following
force	featured office returned country ended
name	northern album members entire
behind	became east head island novel damage
have	have above very earlier
front	father real opening name then
little	located international towards these left ended
remained	reviews enough member additional include north even died
list	later into single their
came	city against made event
crew	command race eventually without
provided	published region opening very itself development east different
wife	written including following every
novel	number ordered various every last
away	action well among years
points	parts original into novel total still
around	aircraft remained once using novel decided
children	crew history introduced line death received ended never
well	whose evidence later long
event	eventually victory ever north than
television	three election level established very included scene idea originally named
time	third island match each
love	lost other video episode
house	have originally usually side especially
right	released including goal held three
country	crew office under never team result young
best	because event social turned
month	music opened near tropical hand
cast	construction according signed thought
battle	between again television through live earlier
church	cast head units received considered held
goal	games office aircraft land
species	such points every court island enough site
either	eight included television house election reported
great	goal region earlier around those
third	them head included round decided
sometimes	scene once million ended time initially main enough scene
similar	species itself must island level addition record
side	species including decided eventually
death	design ever away that highway
team	then entire areas music
claimed	children lower aircraft including move evidence during
appeared	album positive point entire among rest entire died
could	case once until lost different
studio	sound there until different itself once
seen	served especially each novel
however	half opening where especially very episode relationship
created	campaign review early areas training every days
while	when history into later enough
much	move under class hours
leading	local earlier away does instead near game
studio	since tour using died itself order
form	fire ordered remained music
initially	international night introduced tropical important away land lower year
claimed	campaign largest added involved miles early developed
miles	main instead land enough star
opening	originally part east never interest noted general
reported	required ended passed other recorded troops entire directed
public	performance usually behind least important continued
national	near already their into official number above lead
moved	move others very each director
playing	party lost aircraft young include near gave
hand	held appearance name different
featured	features ended above third using replaced eight developed
seen	second even earlier name
five	feet include various enough
name	name according more eventually
future	free used thought using rather events
right	role idea great human team
performance	place especially release free other relationship most album novel career earlier
close	company live once south entire
rest	road early study town
brother	building role only three hours earlier right
election	earlier long eventually could thought island once national
them	tropical held enough months
possible	post originally station seven international both largest events
episode	enough passed include system originally designed event
others	ordered them highway enough rather section
made	match away directed events
instead	included north show tour east appeared described
failed	family about international lines early down
white	writing held involved term east
central	career ever national this runs album later
initially	island novel issue town increased around level least year
while	water however instead located especially
lead	light entire already during
range	recorded announced number groups events
having	have again very introduced name government
ever	established very established review
minutes	months idea name units than either storm
before	both early four official reached ever
highest	high instead going held eight series those
lost	loss original star told
part	population album review total
without	went instead turned home only units turned
placed	performed late attempt control election directed
because	become events called away under ship east
field	front interest either live developed
original	other recorded important going interest nine around lead
reached	reviews evidence across city highest eight decided
feet	films especially entire three
however	highest original water elements victory elements returned
four	four originally under role
within	written itself troops hurricane into noted
children	chart hurricane instead light down road enough northern
turned	town units runs night event decision
important	including moved positive often result tropical almost named there
turned	told until reported near early designed
song	sent order name generally
usually	until signed units available league level year
base	behind average scored every
main	many away initially number
miles	more include life every said
fire	from increased required earlier
highway	held important government hours wanted additional year
damage	despite album modern area gave eventually
within	winds international there high introduced name
using	units star instead name gave
largest	lower according race going every state team
found	family open units name decided
class	cast life army species still
gave	groups above various earlier
case	character according southern elements
life	little introduced felt early
winds	without introduced national director study
lead	local eight area developed
above	around became office video election
history	heavy increased such time often reached young
made	mother almost during elements
field	front issue events late during
ships	state hand international provided served
according	already change company once race different important never game
ended	election named does established died
live	line interest very especially
described	during early served crew record into born ended developed
however	highway once wrote each very especially recording
based	because across soon event days
included	island near common life using design east down
received	route eight city eight involved video events designed
range	released across north goal ended
player	possible land along young entire road
front	finished replaced original named then
given	general island very either nine
completed	control open million person league even term enough development
debut	down ever battle units there
interest	included night they enough result even stated troops
began	built eight great away nine
year	years enough action runs
directed	director interest range earlier cast title east decision
