malice	employ patron alter viral scripts reactor
decor	adoption devised activist dome trails
holed	thermal sounded clever detect advisory
purest	spans runners promptly heated isotopes statues
pastime	spore valid assured steal diesel emotion reopened
mistrust	employ sits isotopes stomach premise authored assured strictly
revamp	trace lecture overtime manor impacted spirits
shoved	assured shoots compact evacuate leather admits
solves	assured contacts platoon evacuate helium assured
pelts	spectrum detect alumni stunt isotopes
prelates	opener presumed mere client tales steals melodic isotopes
coyote	acute mortar hyphae corn stomach peers
credence	acute traces reddish odds nerve invested accepts melodic
spicy	assured spans sits activist pyramid
scandium	isotopes scripts hardly entries admits pioneer humorous amid
replayed	crushed medley spans clause halls hyphae realism admits
cellars	screened deadline clusters cluster halt promptly assured
tosses	steals counts isotopes isotopes depict isotopes
valour	overlap valid alter corn sued criteria
laird	plots hate lion trout adoption
harem	throat vampire promises memoirs impacted
taunts	starter parade purely interim strain isotopes
steeple	isotopes stranded relieve deer spore clinical lecture
cheeses	accepts shale senator reunited isotopes mere assured
cauldron	scripts payments humorous slope advisory prone mount anchored
plainly	spirits cloth valid aims unity clever hyphae
runic	prints runners ancestry rises activist
roast	array corners parade assured stomach
marchers	amid dancer pride scripts thermal lecture erupted isotopes
reload	erupted leased slot commit dancer odds
hepatic	throat develops spirits rats steal mills activist
primal	appoint drops tiny amounted hate slot
ante	catches anchor starter heated
mace	emotion valued screened depends
sentry	isotopes devised anchored statute pride pyramid
impasse	hiatus amino spirits harder isotopes isotopes depends
heed	throat lectures secular admits
annular	hailed indirect entity humorous plots saint presumed
adapter	valid odds patron spans starter reddish cream
rupees	proven muscles spore deleted sends isotopes
undo	runners invested editors commands
scutes	assured screened humorous statues lecture assured
erode	hell trenches solve adoption servant
pulsar	spore purple slopes assured saves crushed
uric	currents creators disco iconic
pretense	spans trails sends stranded recall enclosed assured reacted
prep	appoint creators depict opener
cutscene	acute ruined strain assured scripts median insect reacted
soundly	assured soccer muscles anchor odds slopes pyramid
patched	spirits saves statute accepts shed relay advisory
pincer	appoint rises entirety schemes leather pride
voodoo	evacuate morale morale odds routed conceded
ailment	calendar disco clinical impacted peers insect statute
returner	trails persona stranded nucleus dreams endemic remnant trap
ulcer	lunch slopes accepts develops prints
sirens	assured tier triumph hell entity isotopes
escalate	servant assured accepts harder slopes valued steal meantime
clams	iconic alter lauded immune assured
covertly	activist rode evacuate median cream stunt clusters pyramid
dice	advisory virtual iconic lectures
toddler	statues corners editors editors platoon hectares drops
sacral	isotopes catches scripts premise tales plastic
vase	overlap patron isotopes resume
stun	assured stomach purely endemic
aldermen	happens clause editors demon prone smallest resume onset
phyla	appoint chains pyramid plots saint
tricolor	strain erupted rituals acute hotels cluster morale prone
tint	stunt riots onset strain
hectic	shed medley schemes stomach hiatus acute
patio	spectrum captive steal disco conceded
inhaled	yield indirect shapes canon slot mentor admits
driest	odds presumed riots meantime isotopes stunt
contours	schemes commit endemic statues rode lunar prose assured
candid	schemes catches invested adoption pioneer admits
prairies	spectrum trap paths rituals pride sitcom detect assured
delle	advisory leather cloth platoon deleted
masons	impacted lauded assured sounded unhappy isotopes
carousel	screened papal drops comedian lunch isotopes median cluster
hideous	throat mineral admits medley honest auction isotopes
laymen	slopes ears hyphae immune reunited innocent
nepotism	ensured servant spectrum commands steals viral isotopes impacted
prudent	spore trap sued adoption persona entity strictly
aptly	hardly spur stunt clusters hyphae
minstrel	employ hiatus invested isotopes strictly creators medley platoon
hash	shelters patent isotopes throat
cation	schemes dancer strictly sits monsoon inter
shin	assured chaos riots entries
chimes	scripts throat diesel immune declare isotopes
overseer	poets overlap memoirs priests isotopes melodies tears trails
overruns	lord evacuate realism promises proud muscles entirety assured
tripped	statute criteria yield spans spans servant editors
ovaries	morale overtime canon array lion sends assured
elapsed	servant plastic patent spirits isotopes resume odds
spec	assured spur detect activist
hearth	shed reactor calm prose steal shale
hipped	shirts lion spectrum spectrum memoirs advisory
eater	reunited calendar stranded hell creators
sulphur	isotopes currents clinical spirits shale nurse premise
stylus	isotopes strictly hyphae alumni currents isotopes
prima	spirits triumph yield amid caps
