mentor	impala reload ante steeple sorcery precedes
loves	slander nosed overload dentary usurper
tears	stylus cellars taunts primal escalate
purely	spicy outro tricolor decor plastics lymphoma
leather	aldermen decipher carousel steeple cheeses lettered arrayed
innocent	dice annular inhaled coyote scares yells undo stylus
sitcom	usurper pianists starch scutes pounded omits
dances	adapter cation ante scandium heed astute
patent	spicy radiate stylus decipher anytime stair
loans	slices covertly natal unsuited astute
stranded	usurper attest prairies candid inline edicts sentry adapter
locals	alchemy couplet screamed cation plastics escalate
activist	patched scrum steeple siren overruns tint escalate attest
tales	steeple candid plainly decor astute
enclosed	heed inhaled scraped alchemy toddler usurper returner edulis
adoption	candid edulis sorcery upload attest pianists moose inline
captive	screamed taunts spicy starve pianists ovaries lenient
depict	edicts peppers spec ailment scares attest
heated	shoved recur cavern stair lettered edicts
halls	chops handmade classy clams escalate
array	tactile driest pretense radiant mycelia
hyphae	cheapest mycelia aphids cheeses handmade relays
reactor	uric eels radiant scandium stair politely prairies
muscles	eminence sulphur escalate scrum alchemy eels escalate
lectures	clams hectic screamed steeple purest credence eels escalate
torture	attest solace driest starch sulphur primal deletion
amino	natal emirate diocesan inertial tosses
cloth	scrum classy corset stair phyla
evacuate	detain ovaries cavern scutes supper handmade steeple deletion
throat	starch cheapest prelates colon caravans stylus
vampire	ovaries masons impala aptly diocesan trite reindeer
immune	mistrust impala omits outro entropy deadpan
slot	escalate classy molded stun
rats	prima mace starch escalate
resist	driest decor usurper airspeed usurper utensils
convoys	scrum coerced inline overruns moose mycelia usurper
odds	lorries edicts adapter usurper
statues	astute starve radiant stylus huia sentry usurper
nominee	inertial colon impasse airspeed entropy deadpan reload
parade	spec ravines primal cauldron adapter decipher
aims	candid hipped eminence escalate
alumni	mayhem slander huia omits inertial sirens
sends	escalate nepotism inertial edicts escalate
cooler	scraped moose nosed plastics deletion prima
punt	aptly dualism inertial stylus
clinical	scraped classy diocesan annular sirens scrum mannered ulcer
trap	starve tripped taunts appended
indirect	diploid unsuited edicts pincer precedes decor scrum attest
happens	chops patched spicy aphids decor annular escalate
reddish	erode returner edulis adapter minstrel usurper cheeses
commit	scrum nomads eminence eminence dined stylus
median	imperium relays edulis pincer carousel inhaled
editors	nematode edicts diploid utensils moulds precedes escalate
overtime	moulds overload heed troupes stylus dice eminence hearth
nurse	ante runic prelates astute secede
prints	aphids trite airspeed annular attest astute
promptly	upload urns roast emirate aptly stair elapsed mycelia
acute	laird scrum nuances stun yells
consoles	scares codon inertial astute volt slices lenient usurper
torn	stun coerced trite ante
sharply	escalate cheeses narrate tricolor aphids elapsed nymph
mortar	imperium molded tremor utensils dammed troupes
dome	edicts volt imperium eels
calm	scraped cation plastics impasse
develops	adapter dentary overruns recur classy codon spicy escalate
mouse	eminence moose lurid astute deadpan
survives	escalate hurled uric overload diploid ovaries meanders usurper
tier	starve airspeed lettered tremor
trails	stair primal ravines siren slander escalate
sided	astute diploid edulis recur edulis
coaster	scares solves caravans usurper stylus detain pretense
leased	aldermen deterred tactile usurper peppers adapter
variants	overseer caravans erode linemen pastime undo starch escalate
harder	chipped malice prairies edicts recur tremor
impacted	airspeed eminence spec pastime scrum attest heed edulis
slope	usurper aldermen holed upload deletion
iconic	sirens screamed colon inertial ailment screamed
authored	mannered sulphur starch chops codon tripped lettered edulis
remnant	prima deletion eminence inline sacral anytime stair
diesel	edulis pincer lettered usurper eels classy
invested	hideous inertial overload peppers usurper stylus lenient edulis
melodic	emirate pelts plainly cops adapter minstrel scutes
tired	stun sirens erode lettered edulis
isotopes	pincer astute holed utensils roast upload relays usurper
caps	scares masons upload escalate
routed	prelates coerced aunts stair hearth edicts
lord	clams moose driest adapter
tender	stun reindeer anytime edulis detain troupes
comedian	scandium solace impasse reload adapter diocesan narrate annular
contacts	screamed sorcery anytime attest cation scutes stair astute
visuals	overruns diploid escalate purest cathode plastics usurper
surveys	escalate supper prep overseer meanders typhus escalate
mineral	eminence ailment inhaled deletion prep cadres elapsed
amid	cathode omits dined edicts
clever	screamed aldermen relays overload hectic trite
pinned	aphids linemen annular inertial nematode edicts
drops	edulis uric codon upload escalate
calcium	screamed malice alchemy scandium linemen runic omits
shapes	astute shoals campy upload reindeer escalate
shale	usurper sheen tactile elves hectic
