malice	emstsps eacr dleey ric acnen ceeeeht
decor	edacl mer dccdteh noesu ers
holed	rhldcs toecee slasnp teunin idlsl
purest	spidl aunup arse eechmpd usrti ithtrla
pastime	sprii oae tsdea dtlai tiehtad rmetms seeaerp
mistrust	umsprre oim eselnr etrte ersuu suel ysnut cthis
revamp	srpa ieets lvesica eaaeai tmtnrd npd
shoved	esceep yhrlue eoarltp evprlot reao ddutre
solves	rsupcc soeelas clne ovratrt uetrni oseurln
pelts	cpt eess elvp etrere esuclaa
prelates	lpt uractrr eespsrc aleiarc aaua ntrtr eere pseeris
coyote	ocnphua horpa vysr somim otoi temsmnd
credence	pcpydt pre aeatdi rdudpr neparc pnesrr rcsypd teodes
spicy	asaleea tpc sioisu mccc symeuh
scandium	asnrt mcrt iaeia vnc rdetne rius eurt pmraes
replayed	drn peuh sppcs elhsla taiiapn rysin meuus ldula
cellars	ycicrpd meheael alee rlluds raelc ersypor esasao
tosses	etrtcli eorurr tspuerl aslmea seaea espicvs
valour	vvilrso vaiur olcs uoruo nucsre ure
laird	sledea aaen aipdrn drteel mdpnui
harem	thhy iaemaln eri resunr cmrdryp
taunts	etsec yaurl sulect inr uttta dsths
steeple	sseyrt rtnti eeeips sectp dpr slree uehuael
cheeses	ccprseu ehdhde ueacrde nea hsteri rei asedh
cauldron	echiedc oamnemd pus rleeiam edepr arc noresnt nnd
plainly	epdpd dlotch oasvua uiee end slie dydame
runic	ori aucu pnn eipaet icumseh
roast	oruer soslcn tartnu ssdapn stei
marchers	emlice easn eriroed rcedsas uhet ieuee rrra psdrpe
reload	aryttde ceel elcypl rocmnm aacde sdnplu
hepatic	shmd derpcsr spasr macp stoya hiuteus rcpe
primal	rpat ern pinnede cmeenpa lasems ylricai
ante	saryecs snelca rtmyu hemtla
mace	vmced dariasl aciaep pepraas
sentry	nsllele meieic aneaei atusi srcns lylath
impasse	yidseh cmeoes lpia hasa nstea estacum eee
heed	pherdt aesecer peiisp ldedv
annular	aaimp end tneritu suee pluueo layrae nralsdd
adapter	paornr sdaddl earaash ipt dtpcc petcus ernndp
rupees	lrdrtea rucyaa lpps ueael eeaiav msttn
undo	iute tntpsyi edtsl doluuin
scutes	asnph dcmlds ruapla atspee eeeuatr lssuere
erode	eeste rreueed locsri sdeds deespuc
pulsar	yprnd lueana ilaese hsuptui nas ars
uric	suns ereiade sipet scsardu
pretense	aphl tri seyec uttns yest ynluy nslce iearn
prep	ipua rriotr oeepeny lpsde
cutscene	lcemadu ausd etcla usread ecridae rencs enorem peavu
soundly	lseei poua suso lne cdham tlsom nyeselt
patched	spsd lacdes rtcey actrati ohpe cepec ydhas
pincer	tpl sinayi nnietm tccs aeemml nrte
voodoo	mvcorne lormpn sodtsee adoers doevo uodan
ailment	uasne ciu elcn emdclep oeln rneaee stnsal
returner	iren remtn htempd iuad hroor uni eeoeesc rrpe
ulcer	muml elrcse acrhoy deacer orpro
sirens	hsaplt iieeoh urteped reulaer lndlac esdiora
escalate	nelyemi pscca scare yarsa lletu harsyte mtrss deaat
clams	rctntom mlsriee yahda emmu esaes
covertly	pcnlrcs eoedya mviuree eercret urs rtrma elar eyisce
dice	idesrt pieua dcntrdn aedsesa
toddler	etoa molicet idonss sdraat llidr eect lrpemar
sacral	asthc ianmu ecma dreliu raycy mlasre
vase	uvuoaee randsnp dsshry iearrl
stun	rssli etenta autp cnu
aldermen	raieesc dlasi ddost seepvh hrecyin hmpuc ceeas rnn
phyla	ppv phypes iyunr aldse hacce
tricolor	etr mrrmrsi oinum mcpspnn soyites aleede loncol erc
tint	tts tieilps enade atnie
hectic	uhlsr sepsras pceie atprhss diena hcdieo
patio	mps laeee ctncet pinvss eoooe
inhaled	pihsn ans nhseo satsmca ellnsu reaotd ddairp
driest	edtrpe prpedn eiia aeadat useteds rtac
contours	ecpel poeee inrsys otsaer morpurc uutru srp aserye
candid	pctymau aarul tnepnr edtle iiiema ddodae
prairies	spdn srcn marertt eiesl rrp eire pep isnuee
delle	hddtc eeyip alapse cltycn ierts
masons	smitpe eatmam tsela doiet tnt lsdeeau
carousel	ucrsusn eadre ird uopl rudn ssseri eeeetnl alrpem
hideous	ihey lirt sdnhe setla eosds tuorr psaesea
laymen	vlcn nasenrm hyme tmpietn eeaecsi ena
nepotism	rnpueai nearusl sprat uomla stcim diseup hsidee rmtshr
prudent	upra drscud lucse tdneu leplss enicuis ittrp
aptly	aaessc tpmp mtii clriph yyyn
minstrel	pmtstt lierpr anytin esasls utuah yrucpa ueeih rlrddmi
hash	ehsta oaa asusy hhph
cation	ncmstat yarsnh etdpee ailpiae eoal rntimn
shin	essrnt ohuee risu unurdsp
chimes	ccsdre shearl pirip pmpcae eec usasnu
overseer	noe avsoeep nepotre ermuidr osioh ees teisemt trcaspc
overruns	roitt rvesral oeeieum drvs iro nuremti pnulipl pspupe
tripped	rtmdt prt sieavst ips speur aensa udchmp
ovaries	tortaiu uvhclss daap crpneo sitru nerhee tseeu
elapsed	lec slcs rardc ipa eseeru reeunea rderes
spec	aspse sprc herhe acdtiy
hearth	vhrce nendpse iaad drtsncs its ehe
hipped	ehi lia spncs dpis reithi ndsly
eater	ienmeer vass ttner reatppe proniie
sulphur	rsspeda eurtnne sleeene tpe ihmccs eucn traecec
stylus	usaulcp atsad rylareh eleoes rutap psrvel
prima	pple ire piottyh hmar sas
