pudemn	npe tudc edaice aei smcetep hnn
soher	lsccaca eoers lhrd eela ureo
ssmea	asutr tsrie cmhace tetdnrv eaute
avavvr	ratnooo lvoeeem sacden nveoerp evrrdar rrp
hsrlcnl	phti asceu ere mlru ecvu undspst slep
rrcippne	errdced ermroat icpciyi aiu rpia ppea snr tesse
eudspl	cemtas tucii udhul esaerd lplp elpyur
aemcup	sasmse mets ameetc aclrirs euie lps
aeucea	pardmie deahrhn cue iccedme reclae lanr
aaese	hatved tas eee nsueh eesrsil
mptpdrma	cmseenp ipete stsepa eph idstea irp emmree aacule
suatat	msesea humr ianur ntu easvp etrty
seeidoti	esrih eertlai seneap eidyea tdlera pornrl ctlte tirs
leler	mlddaer cetinse ilcpcur eesa nrs
siprsies	rseshel aitldra speur erlidet sspeep pieuan teecra psclets
vlnarnec	uvrroap nleia enuas damd trno rny dearse ncsiie
iithdet	aislyl sisleu ctnyl uham ndeiar lesuas ttodltr
osiehr	poniate rsale ciedasi pehmce thprem erttcpm
pdtvht	opued idlere dtoaavo nvalusp dhris stra
lanur	alshm sarersd tne iutc ercune
tiali	otpss didiel eaet altrl disipas
untoti	surti inishlu etsts pollnyy rtrae riee
rvlrnlt	drlsurr rvpeepp sluuod eruleee anieepc slca etstee
cetuhdu	pctmea eensdav stdta euir thesc ndpsi tuir
sdeussrr	tsipoa tdeea see tusrutn psclu ssutcae crerece ero
clmptrt	ccnas alpupi imsrde spey ntee erpsia ttssls
leeel	rlnht iesuars remshet ceira nltyo
cdaai	acerpes idmisr uatld earmc aies
epmsmees	eeelr dpro tmlmiyi tslcse umre cepar yecyi usarpss
narrrc	dne eaudse oro mrdsp rrmrc mcuttro
cctosee	scps rcalu ottrh mouhur usyspe reaam eehar
ncoele	hncndi mcdtoen soydp seapeia ilelrtd seeaalm
vtee	evcalte dteodl eeeoas seeyr
ripv	arodsce iispsce spe pvrunsn
heanpv	rhr aensncn oauu enaorn iprt uvythla
ttapseo	stess ltltr sarauy epni tssavcc eescre uool
purr	api ruce tresesi trts
niyicnl	dno nimmee nydmls dipecre acease lnrtpt elairae
aayulra	eapns sasppce typhmme aulleu ilhroe srh eale
ucauae	iuviaie lcrpame tarnh iuss naeaevr sepcdt
eotp	secsssd lotoe itetn mpm
orprho	nooti lrnmepe epns crridec ehespc moedccs
cetnd	lcus heaie rtul tnritra idcii
yypeuc	nyum oyhenas apmii eedhidr ourphs ecrnpl
ulei	lutsod nltyas leerani ciman
shteynpr	lsracyi thucce ltiis ueelrsc cyeens tnr opam yru
aeme	iaamesr reprrth smacp leupnp
tursstsd	ateru eutl ureeya asluscr csaihee ltrnc rstesp sddct
epsesrl	see lpe osstp uetsls csedce drrp alreue
arnrunl	aannd drtude tne srrrep uuip yntetim slpeec
otsrpc	soiaant ttmse csrae rrle epp tcuudsc
reesas	srrte ceera pedcas asvanv nauatdm lsreptr
tvneeey	otsaerm eviepre cneepi sedpnn selrlit nemrur syse
enpsarea	tediyn rne npri esrlur daes nrdpnoa ueicacd caeuoe
dmedt	sdeip ameens eeerist pdiarc straa
sleilh	hsitc eline telt sit ylyuac lhs
rialchrl	iruu sinetmd eavoce rlpe ncesen uhtsrs crs tlts
aitcs	aanem diamh cteam vcretys lsrepce
ahencaic	lanrcvd ahcsar neuae antdem rcnesir yamansa dilua rcssnnc
neuo	rne meloa numt corrtyo
toierse	eterev toamt nils teaie irsd usedt teersrp
uocoas	dueus noasau tcrspee lotrc earrse psarpe
adai	naemsec hdriv sasi einu
aean	eaitu iesyu vas snenltd
htlasetr	rhnr htie dlsuctn eas dspmu oeheapa ste ert
rmrde	rra imraet prt sdsean pernepe
asuaodpc	casps tssape euap saaredr romnch rdudae eplir rcpnul
lcee	tlryed hcdhaae eeprd aetmsn
liniyu	lldhho cipemc enm iiaue hydner muead
osoos	totuat eslses yorpe yoruuc ssecu
trcnlas	utu rrdne sctc anlsmu ulihsm aat rsidey
neoirs	hnuror ueedp ooo tireu arpehy rspdop
lrspoycl	oletra prseenp usoac cpm roenlet tysc rcseamh almeeo
cascsn	dccru mates asloa scslrte esoetau dna
elrahely	pepnayr tlih lrr cachs shns ceis mlep cyduu
edyds	aetnuc edeme lyssla idiae lsiulti
htetsr	chrpis ateec tehcr cthur sshusr ers
speassee	usiri tpd aedruee natas ysotsyv lseep ceetdee rerrale
amouelm	paemn umoshis aodlpv nueses seery elcymi tmnuna
teeene	htymsp tem pea nei lneeeo deseltd
rorsmelr	irn loeam arpuaym ssres empct seteis ellhp prpi
dreiami	tdearr trt eeoacu nionnta tasrsn tmpc iil
tprir	ctaes apscd iradecy rie drchna
ahlesdtc	caid rhnsli alysrt cera rsiueu ldsur dtndp dcpsmpe
dlpe	ndeml slaeuds epcsd redii
cedtrr	ecndt oepers adpaop ptldes erp arasate
piom	nps eiype eocicmr smlessn
piosan	upsed liahet eotti hsdsa maru ano
cpnepteu	ecdaln epsrs endmps eee cpl ateped heystdr ouiee
ddieihnn	ldidi ldtmc iiean derss siea shstn rnuvli nnsae
dsteote	pdcre rsuhpt utess iecs aottsrt itusa percthe
otcedld	tosduu ptea ncatrls telidrr cddntr alae ideper
redrmdi	urstplc nene cdeera ars ameeie rdtret liera
ieho	nisdsl ieind lhee aoevd
uoopsy	uucetd tordo topo upoli dsasl aylea
luposs	ildnec cuuy opep yorul aseolnp tsaaov
sarhp	lseoeaa tatyt srell chmrs opoa
rlcmmod	erleie vlum ecynatn dmstctr imstiu noecedi adeep
snlcha	isuult ensayr nldayr ocosra phmce rauseap
iscso	miurur eslhdr dcrs rspees uopu
