malice	move appeared level interest called even
decor	director every command open result
holed	held order lead even directed
purest	play under record event southern this
pastime	provided action south title interest many either
mistrust	music instead studio time replaced under started that
revamp	runs earlier very army modern played
shoved	seven house only various ended directed
solves	such once lost very east station
pelts	process ended less times state
prelates	process release event late added turned entire stated
coyote	career over years over term ended
credence	command rather east directed elements never career events
spicy	scene provided include come year
scandium	site came across noted decided include under military
replayed	remained elements player lines appeared year every death
cellars	close early list last another reached system
tosses	these open side short every support
valour	victory addition located over units reported
laird	lines attempt island race directed
harem	human appeared race east mother
taunts	than attempt under noted team service
steeple	similar total east ever play live early
cheeses	came human east episode sold entire site
cauldron	class army used lead decided rather ordered northern
plainly	player located around involved named lost years
runic	replaced under name instead called
roast	reached order also ship time
marchers	million appeared route created house entire record scene
reload	route east local outside also despite
hepatic	human ever previous army third into court
primal	point result island moved army last
ante	army never term ended
mace	much army called event
sentry	still episode nine title rest years
impasse	into month praised added season sold east
heed	held earlier each director
annular	area never name used lost almost release
adapter	army days army passed then ended replaced
rupees	rather until passed elements ended started
undo	until nine death other
scutes	story created upon times events south
erode	every remained others despite east
pulsar	party until live soon almost reported
uric	units remained island come
pretense	play runs even there events noted school early
prep	period released either party
cutscene	came used title southern created earlier name elements
soundly	station opened upon noted died local years
patched	players army that control held elements director
pincer	popular instead name cast east result
voodoo	version order over does once only
ailment	addition instead located million every northern times
returner	road either term until reported northern elements reached
ulcer	units level called early recorded
sirens	state interest rest either national story
escalate	event south came another little added team elements
clams	class late addition music station
covertly	church ordered very entire role there level years
dice	despite interest come early
toddler	total over death despite love elements reported
sacral	storm action control return areas list
vase	very attempt should event
stun	south tropical units northern
aldermen	almost late death entire recorded miles either never
phyla	previous history year located across
tricolor	team runs include company others local outside road
tint	three involved north turned
hectic	human entire century than interest caused
patio	produced almost those instead other
inhaled	interest northern house almost little each does
driest	decided role included either several those
contours	class order north term open used reached started
candid	control around national does island death
prairies	period received almost into received involved earlier station
delle	died elements list late earlier
masons	modern another sold once name should
carousel	career area remained others until seven elements last
hideous	history included death ended open under sound
laymen	land areas years million ever name
nepotism	named ended provided open this interest special music
prudent	point rather under decided east name turned
aptly	added produced there list years
minstrel	million instead never support tropical role east list
hash	heavy across still help
cation	come across title include ordered name
shin	south have instead north
chimes	children heavy included miles episode soon
overseer	other various ever received system every ever route
overruns	outside various each recorded return upon named similar
tripped	third received interest positive people event directed
ovaries	once various attempt reported island even ship
elapsed	each level across placed such ended death
spec	school parts events company
hearth	history entire across role times human
hipped	hours into present parts elements does
eater	early almost told east reported
sulphur	ships units last position heavy units record
stylus	state their year less until start
prima	play runs island move another
