studio	starve troupes urns decipher inhaled outro
third	typhus hash impasse revamp decor
ships	sheen heed inhaled peppers saline
states	starve typhus aptly taunts eminence starve
special	starve pumice emirate chops inertial appended landmass
returned	revamp entropy tint urns radiant nuances elapsed diocesan
little	lettered imperium trite tint lures edicts
church	classy hoop uric relays chipped hash
mother	molded outro typhus hoop elves runic
named	nematode astute masons eater delle
received	ruinous emirate cheeses eminence inline voodoo eater deadpan
common	cutscene outro minstrel minstrel omits natal
elements	elves laird erode malice erode nuances taunts scrum
style	shoved taunts yells landmass edicts
military	masons inhaled lorries inline tint aunts runic yells
involved	inhaled nepotism vase overload linemen valour edicts dammed
include	inhaled nomads cutscene lorries uric deterred escalate
events	elves vanishes edicts nepotism tremor solves
island	imperium sonnets linemen attest nuances deadpan
north	narrate outro radiate tactile harem
scene	savior commoner edulis natal escalate
scored	starve couplet overload relays edulis docile
reached	roast eater ailment carousel hipped eater driest
million	mayhem inhaled lymphoma lettered inertial outro nematode
provided	purest replayed outro valour inhaled dentary erode decipher
critics	couplet runes inertial troupes inhaled cairn saline
three	taunts hurled reprieve eminence elapsed
chart	contours hoop aptly reindeer tricolor
tropical	tosses radiate omits pretense inertial cutscene arrayed lurid
rather	reindeer attest tosses hipped escalate ruinous
company	cops omits moose pulsar aldermen nematode yells
points	pianists outro imperium natal tremor starch
less	locusts elapsed sentry shin
live	laymen imperium voodoo escalate
entire	elves nematode tosses inertial reverts eater
century	campy elves nuances tosses urns runes yells
said	starch aptly imperium driest
episode	eminence prima inhaled scutes outro decipher emirate
species	spec pincer edicts cantons imperium edicts shin
caused	cutscene attest utensils sentry erode dammed
name	natal arrayed marchers eels
played	prairies laymen alchemy yells elves dentary
areas	annular rupees eminence anytime slander
action	attest cation toddler impasse overseer narrate
tour	tint overruns usurper radiate
released	ravines escalate laird eels arrayed spec eels diploid
lost	linemen omits sentry toddler
director	dammed impala runic eels coyote tricolor overruns revamp
earlier	edicts aptly reindeer lettered impala edicts reverts
outside	overseer upload tremor solves impasse driest entropy
period	phyla eater rupees imperium overseer deterred
passed	precedes annular sheen starve emirate docile
minutes	moose inline nepotism upload typhus eels sentry
children	credence huia impasse linemen docile runes eels nuances
early	escalate anytime relays locusts yells
modern	malice overload dentary elapsed runic narrate
appeared	aphids prudent pelts elapsed ante radiant edulis diploid
level	linemen eminence vanishes edulis linemen
southern	slices overload upload taunts holed elapsed runes nepotism
then	toddler hearth emirate natal
similar	shoals inhaled macho inhaled lettered aldermen radiate
second	solace escalate corset overseer nematode dammed
died	decipher impala edulis diocesan
post	prairies omits starch tint
recorded	ruinous edulis curtail overseer reload delle erode dammed
total	toddler overruns tint attest locusts
reported	recur erode peppers omits recur tricolor eels diploid
sold	scandium overseer laird dualism
almost	annular linemen marchers overseer scutes tosses
route	roast overload undo tint elapsed
created	corset runic edulis annular taunts erode detain
opened	omits patio elves natal elapsed deletion
directed	deterred inertial revamp elves cops toddler entropy dice
career	clams astute reindeer erode emirate reprieve
addition	ailment diploid dice imperium toddler impala outro natal
could	cellars overruns urns lettered detain
either	edicts impasse toddler harem eater reindeer
produced	pulsar returner outro dice uric codon edulis deadpan
process	pumice runic overseer comatose entropy solace sacral
others	overseer tosses hearth escalate recur slices
remained	reindeer elapsed moose aldermen impala narrate eminence diocesan
various	voodoo alchemy roast imperium outro usurper sorcery
spent	stylus purest edicts narrate taunts
interest	impasse nomads taunts edulis recur eels sheen tremor
love	linemen outro valour emirate
placed	polymers lenient annular cheapest erode deterred
site	starch impasse typhus edulis
across	aphids chimes reprieve overruns slices soundly
replaced	reverts elves pumice laymen airspeed comatose elves detain
positive	pounded outro sacral impasse tricolor impala vanishes emirate
attempt	astute trite trite elapsed mace pretense tricolor
support	spicy unsuited prelates pounded overseer reindeer tosses
praised	putative ravines astute impala soundly emirate dualism
even	eater vase emirate nepotism
school	slander coerced hipped overseer overseer lettered
should	sheen huia overruns urns lorries dice
later	landmass aunts tripped elapsed recur
instead	inline nymph savior taunts escalate aunts dualism
people	prudent eater omits patio lenient elves
since	sentry imperium nuances codon erode
