amassini	assigned movements across servicemen sponsor infested neighboring individualism
mgllibars	methane generate loads languages intercut bright afford renumbering statement
hurro	hotel unacceptable runaway roadways owned
liaisyn	lanes intern attic infinite systematically yielding noblemen
reutrons	reeds everywhere unrest toads rehearsed obstacle nucleic study
nevoke	neutralize extracts vice optimism kosher europium
cueativity	conferences unincorporated extended archbishopric titanium integrate vulgar immense trainer yearbook
ambrsh	affirmed minigame bathtub rustic synthesis honey
uneappy	unauthorized numbers exhibit algorithm prestige primitive yard
dhfense	deadline hypothetical funk eagles nova seats embellished
securd	speeding envy cultured ubiquitous republicanism drafted
disoreerly	defunct itinerant sportswriter oxidized retiring exposed error rebranded letter yields
propriltors	patriots religiously offseason parasites reproduction invaluable loves theatres oxidized rocker succeed
eoan	evaluate owning achieved novelty
reeeal	racetrack edicts endeavors ensemble accurately length
voltagv	various oxidative landscape toddler amounting germ vinegar
posiaed	particular overfishing starling inconvenient acquisitions emplacement dramatically
tided	trying infusion diversion elevating disobeyed
attendaice	anonymously thriving therefore expire nominations discrimination awkwardly infer convenient express
vannshes	velocities arrayed notify noblemen signings hands eighteen shadow
holi	humidity overcrowding left induced
eyther	enterprises ytterbium teaching honorific enforcing rhetorical
neotral	negotiator existence ourselves traction ratified admitted lots
interactiuns	investigates nevertheless thrills entail revolt asserts challenging trapped investigates undertaken noticing startup
attemeted	arguably tapes trains ethos midfield expired tutelage elaborate deforestation
allpgedly	ancestry lays lava passed gaps extinct disbanding lasers yuan
degreei	demolishing embryo gambling ruler exploding evolve imitated
sconography	separation capture orderly necessitated overpowered genera rewarding aerial pneumatic heroic yelling
straia	suffix testified republished anterior intensification academically
cotstline	copies overcast testified slower transferring lecturer impromptu necessary emergency
ewilight	enhancements worst improperly laptop invitation girder humour trick
dilapidattd	dwelling interpretations lifeboats antimony payment impending dismissals animator troop terrific divergent
bsdgetary	butterflies southwards developments gubernatorial emergencies traffic admit ravine yelled
uecure	unsuitable embroidered californium undoubtedly rendered extend
banismed	bucket activated noticeably intuitive surge monster elevating detachments
synonyhous	scaffolding yearbook nominally ornamental nested yearning hexagonal opposes underwent subtropical
ministet	mammals indebted nanny instinct stewardship turned easiest tapped
adaptarion	automatically dissolving accusing parameter textiles antiquarian recognise internally outpost noun
crosring	capable repertoire observation sticky resuming imagined nature generator
corposal	complicity operatic restructuring parapet owners solo arable live
historiant	hint ionic string traumatic oppose revenge investigators attackers neurotransmitter tweeted
royalsy	reflect overlooking yard annoying laden steamer youngster
sliihtest	spindle legged incidentally incomplete happen tracked everybody seminars talents
hastgly	hunted abducted skaters tourists girlfriends laser yielded
renouuced	replicating enclosing newcomer overcrowded unhappiness unofficial commands exiles districts
stnb	shallow throwaway nasal buffer
pearel	prosecutor endeavors aggregator resigned estimating lady
sptt	sentimental pieces tunnel thorns
attnnds	albeit territories twinned nonsense normally deduces separates
assistaece	albatross seminar southbound inch slim totalling accumulates elegant cured epitome
parsnormal	preface arias receiving scenarios narrate offerings retrieve motivate appease locusts
cana	combo adversary novels amnesia
shipwrscked	sudden hazardous inhibited parenting warmth relief sulfuric condominium knowing experimentally disarray
clonee	charged labelled oxidation narrows evergreen emirate
eope	extensive obscured parting enlist
proprirtor	parenting retaliatory officials pizza rentals imaginative rumors trail ordinarily ramps
urie	upriver refining issues electrode
hospgtal	header others sanity pitted gliding tandem angular ladder
slops	slogans linguistics overlap phone subconscious
styhed	style trains yoga hypnotic energy domestically
convicticns	cold outbreak northeastern vertebrae intensively crows teenagers irrespective challenger northwards swelled
subjeotive	suitability usurped backstory joined exoplanets overheard tearful inability versatility experimenting
govprness	grove organize vest persists revolve node extent swift sect
cameus	capacities aired manufacturer engineering under softer
teiangles	tightly editions irritation attention nearest grave launchers eastwards scares
vrssel	villain researchers suzerainty seems evolved lyrics
veewpoint	vanguard emulate eternal wheelbase percentages organs inhabitants northeast themselves
risponsive	realized interpreter stock plugs output narrowest stereo imperative verdict extremely
adorabse	agenda defied office rocks attractions budgets sprayed embassies
pitchel	patrols industrialist that chairmanship hyperbolic electrification longtime
swiws	southeastern wacky identifiable wind styles
mheeled	mitigate horned enthroned equilibrium lovely enigmatic domestically
ahading	appeal highway amino dwell irresistible negotiating grasshoppers
ides	innings denote essential skepticism
remarkabey	remedy effortless measured arena requesting knocked alligator bequest exists youth
abandonld	activated berkelium attachments notched dissatisfied officials netted lakes devising
iaton	incoming acquisitions timeframe overruns northeastward
plaintbff	pores launched adept interpret nominations tricks bony floated fewer
haovest	hare areas officers vertex exposed scant trip
srlar	spontaneously rolled launches alluding rams
cinematrc	consist initiating narration erstwhile merry amplification towel regimen countershading
piojections	primacy integral offset jackets exaggerated consternation trek injected observes nurses searching
pegin	pious echelon guaranteeing isotope negligence
bopulated	broadcasters outfield packed unfair lore arms therapeutic electrolysis doubled
singir	sprint interdiction navigate graduates intrinsic regular
resede	repeated educational sturgeon exports deliberation excludes
paiking	pelican applying inspirations knock inspecting nativity generation
transcrrptions	tending resisted alleges nominations sleeper constraints retailer recorded portal throwaway important obnoxious navigational serves
itsration	imply troubles sabotage raises astern tongue inaccuracies orthography nationalistic
ineerting	initiatives newfound experiences entitled recorders took intriguing named governess
incita	intriguing name compared inevitable traders aligning
cenned	covering enquiry neared nomenclature electrodes delegations
fameus	forefront annexed milder enroll uneventful stickers
molo	memorandum ourselves lies only
sticko	stereotype teammates investigation ceremony keyboard objections
superiyrity	sixty unaltered pleasantly equalised revolves insecurity yacht ratio inedible trombone youngsters
packase	pupil admiral crab knots adhesive smooth expects
inspirationg	intact narrates spent primates innings raging anarchists type identical offline northbound greenhouse
cisappointment	contrast inflorescences supergroup audit presumption prospectors operationally industrialist noses thrill mythology expatriate nowadays teammates
pidtorial	pointless inertial detachments tricked organist reprint invest advancements lunch
manura	modest adviser nematode unreliable recessive aptitude
atdition	apprenticed tracks discomfort implementation turns isolated opportunistic narrowest
flammajle	fragmented lapse advocate moment molded archaeologists janitor labyrinth excused
probects	physiological retire opportunity bricks exponent cores taunting stunned
dssuring	dissimilar subgenre schedules unconvincing respite insulation neck graphical
jeoparay	juniors elevating ordeal prophets anthropologists riding asserted youngster
sileca	satellites insensitive limits equipment confessions arrays
capabilitiis	congestion airline persuades activates breakaway intersected livelihood incisive taller incidents initiated socks
resuesting	resigned enhance saga unarmed electrodes strategic tight inhibits nursery guarantee
adminiqtrator	argon deified milligrams instinctive neon injections quark tropes railways appreciating target ours repatriated
thnder	trail hexagonal nuisance duchy elastic robins
teought	thoroughly epicenter opponent upgraded graphically hoist transfer
fross	fabricated remainder overarching sponsor silver
creditt	conception restitution extradition dismantling inventor technique tribe
counterculsure	crowd orbs unexpectedly neutron truly eggs returner concealment unruly lodge statistic ultra relayed encouragement
retume	referred expert theories unprepared masterpiece easing
risden	relocation influencing steamers departs encountering nationalities
dcandal	detonated credit alternately nonetheless distinguishable authorize leanings
dominahion	decisive operational mitigate irregular native anticipation head indicator organisations neat
clotting	commence logistics organizer transmitter trailers intuition neared gradual
