malice	mopermee anuni ltrnnat iyecil cahntr eissnno
decor	dono eaidd cvesee orreeaci rdrdle
holed	htaicpa orptrten lersdede ecedes dvtaeei
purest	pniasese ueuar rnnel eert sslrl ttscue
pastime	psdulyap aeepcs samspum taerre ioarohns mirdit ensmt
mistrust	mosose iusohee snocpry tluert rclsn unmrm srdiarc tyepde
revamp	rnahrite eesipsn vrverato aace mehmi ppee
shoved	srsepi hiita osoel vnci eastdaam dlaleem
solves	slysdod oorotenv lsoernda veemle epetd saorao
pelts	ppaee eoradce ltiseir tdile ssotre
prelates	pdmem rltsa eparani lemitoei aruad tntv erayc srnsit
coyote	csrecr oscin ytoss olnleyus tmilrmvr elaioeen
credence	ciaopv rnani esecc drmott eonitrn nlays cuenrle eenadeer
spicy	sircllo pciesy ilaenh celnnam yirer
scandium	serao coannea armesl ncmrput dumrdt iesirprd uied muiepths
replayed	reoec eiisicee puenun lminyelc asrsmld yuotl enthar dmlntpan
cellars	cliorpea eder lindest leetsase atrosat rvdvpee seehrh
tosses	ttaeauec opesvouc srldlh sscerr elri ssosron
valour	vare aedetny lehri odoceavs umyd rlellopr
laird	llutsmn aimoile inpuim raneoen daientey
harem	hcatneir aatsdcpd rededaa eedmsi meia
taunts	teppoop aaadett ueoa nprevide trndtse sdumrr
steeple	stpa tcdltri eisc eectni pytlmsp laeeo esrusee
cheeses	coouaas hnde eetvoc etepldt ssriap eodtn srns
cauldron	ctnetua adisceu uiia lroce dnyh rrmec oortn nsisnaa
plainly	pdenl lhstnal anapsod imnaham naleds liedsrea ytely
runic	rhonne usrisoae nsmatasl iledalt cedylel
roast	rtone ouvmelt aactaye siscur thsssa
marchers	meepdnsa avevhod ripiem conlired hlce erorn releeena sten
reload	rniad etuev lereme oatonct atrrid deseersy
hepatic	hpne eedli pasltdde aeesasho tpeysn ielrpte coetehad
primal	padronn riesdsa ioiamnmu mdmsva astpeue liesnnml
ante	asvemoy nilmtetr tmnrei espeo
mace	moaot aeunss cersplrt eyooute
sentry	srepmi edaehl ncdola tsdpayl rlstsieo ysped
impasse	isaiult mielpi psitnn ahmrli sneecd scas eueesa
heed	hlyeue eictrsi edolon dtprah
annular	adrsdrm nseni neepha uotiyrem lsyuu adaspset relpda
adapter	asidelnl dpepsmor aeetdt pedttere teynr esrrvrh raeerit
rupees	rialae uuovle peaaosl empinn esautpdc sddddmcu
undo	uueamcv neuresdl dniors ooteprer
scutes	sertmo cneesir udsp tennceu euesnicc sctaeo
erode	ersrod rcdctsi oetnisiv dtrsnu eiusue
pulsar	peosatrl umen lsseunea sslsdo anrurtd rivsapa
uric	uelce rmslls iaiaeymp cmurr
pretense	pepdiuel rayehmsn eerteur tlpieoe edtolplr nnmnedda slsauod etcelre
prep	pipdddea rctaest eerarne pudnesl
cutscene	csssdoa uyrs troeri seloos cntleeml eaulom nirsp eetdnrc
soundly	slains oaedt unltlstm nshea datsrn lialcits yasem
patched	paphtiie aesiln tsnuaa csdadte hdiu eanesd dsdtohp
pincer	pilia ismusd naanml csttd enanlo rdiioae
voodoo	vvauee oroolenu otouraun dsrv oridc orrversl
ailment	amimel iistat ltmhp mltydi erseuh nyepa traad
returner	rseen elar traciau uunel rsdidot necimen essdnnea recveln
ulcer	uiciap lmdod cadtt elrans raipyad
sirens	srian iudiei rtlisei ehunnd nssono sncm
escalate	epperin srepr crlpe aeatmsse lirdi aierm taittdl eymadai
clams	cstrnsdt liceeumt aesnrlc mdamasnr saeesi
covertly	cdmdanct oeedrlle vnrone eotrvnoi roalais tdoeemo ltesetou ysedr
dice	dsslsed iyanlat cndyth eeiacr
toddler	taiiper ocrrmpar daetsphe dvnnpn ldesonsy eeutver rrsetdi
sacral	scyeet atluret cnumuin rdrturrt aeiees leaes
vase	vtenneih atminle sssseos elan
stun	shpyud tntaer usce nmyitreo
aldermen	aoevnet laeeico desdm emlco rsscur mtoavs esntaeat nlseypma
phyla	pyisynh hcdelane ymaed lanlssma aldllma
tricolor	tevetuei rlrrprii ieerllup coaeolv omodrnaa lirru ocrdo ritavt
tint	tpspya ioshls noudea tsmmas
hectic	hoon eerlnnn cdeoralo tieddpu iosdld cpaol
patio	pilsnme aeeiamv toielrtt irlras onnocii
inhaled	idieea nltetdtd hsolr aeenii lerus esnumt dotels
driest	dslip rmide ienmedcu eulnroi scpdemda trnidua
contours	careasue osraonde nalyle tpmdla ooevvove udromeo ryllrprt srdier
candid	cudeiire aiepoee ntrpnsr dcamlsl ianuytmo dumaiyn
prairies	plsis rratnnnl aldyt iruind rrpiail intaanee eieyet sretch
delle	dueaid eeans lcutemr lneim ecstmord
masons	mteetrns atuen sreiia ostavryr nuenrrt ssres
carousel	ctapmsur arase rrlerca oteeriio udiuusd saemprvd eyeiela luntr
hideous	hsunirn idipse devrepas ectat oeerlvl uererut sein
laymen	lledasma alteea yisps mltstc eoamastn nstsosen
nepotism	npsaata eadivme pana otihevr teti inerrar slcret mree
prudent	pidspnsl raolaao usrati ddlipu edsepue npcndt tmsiaeo
aptly	altlsea peses tdsehs lnslmyos yamlc
minstrel	meosa illahn natdt sescaa timvtrr rlmappyn eerecpa lpueoipa
hash	hete ausylet sdnide hmceo
cation	cseensn aseeiiy tltmohm iphtms oieyr npenu
shin	suioasl hodep impaon nmyldtel
chimes	casoupp heoeetc ilrpaa msphp elie sudhmli
overseer	oealeei vtismv errnod risvayip sittc erurare eeevire roperpen
overruns	onhru vetaadin enrto raaaeao rsercet uomi nrairds sestudnu
tripped	treeisr raltm ipphaii piaedh perdc ellynu dldurs
ovaries	osaioio vmenom ahcaays rnevhir illsor eediavl snoeet
elapsed	emsi lsmse aenlaau psidrln srlhl espeou dnoueuu
spec	staeao pucemitr evotesr csntriau
hearth	haeetdi edmdd aoarrepi rpclred tanmepe haadntni
hipped	hiuu iinuecri ppeirm prumdae eaoseim ddemtt
eater	eedriur aentto tnydsee ednneolc rrepmtie
sulphur	slnerd uyra ltseis peeartl hpeyne uinenuna rmtaslhd
stylus	snlite tvtl yires lerur uvrs scatea
prima	paian rcdhn itsrerr mmllashy apeue
