amassing	assigned movements across servicemen sponsor infested neighboring generate
millibars	methane individualism loads languages intercut bright afford renumbering statement
hurry	hotel unacceptable runaway roadways yielding
liaison	lanes intern attic infinite systematically owned noblemen
neutrons	neutralize everywhere unrest toads rehearsed obstacle nucleic study
revoke	reeds extracts vice optimism kosher europium
creativity	conferences rustic extended archbishopric titanium integrate vulgar immense trainer yearbook
ambush	affirmed minigame bathtub unincorporated synthesis honey
unhappy	unauthorized numbers hypothetical algorithm prestige primitive yard
defense	deadline exhibit funk eagles nova seats embellished
secure	speeding envy cultured ubiquitous republicanism exposed
disorderly	defunct itinerant sportswriter oxidized retiring drafted error rebranded letter yields
proprietors	patriots religiously offseason parasites reproduction invaluable evaluate theatres oxidized rocker succeed
loan	loves owning achieved novelty
reveal	racetrack edicts vinegar ensemble accurately length
voltage	various oxidative landscape toddler amounting germ endeavors
posited	particular overfishing starling inconvenient trying emplacement dramatically
aided	acquisitions infusion diversion elevating disobeyed
attendance	anonymously thriving therefore expire nominations discrimination awkwardly noblemen convenient express
vanishes	velocities arrayed notify infer signings hands eighteen shadow
holy	humidity overcrowding left ytterbium
either	enterprises induced teaching honorific enforcing rhetorical
neutral	negotiator existence undertaken traction ratified admitted lots
interactions	investigates nevertheless thrills entail revolt asserts challenging trapped investigates ourselves noticing startup
attempted	arguably tapes trains ethos midfield passed tutelage elaborate deforestation
allegedly	ancestry lays lava expired gaps extinct disbanding lasers yuan
degrees	demolishing embryo gambling ruler exploding evolve separation
iconography	imitated capture orderly necessitated overpowered genera rewarding aerial pneumatic heroic yelling
strait	suffix testified republished anterior intensification testified
coastline	copies overcast academically slower transferring lecturer impromptu necessary emergency
twilight	terrific worst improperly laptop invitation girder humour trick
dilapidated	dwelling interpretations lifeboats antimony payment impending dismissals animator troop enhancements divergent
budgetary	butterflies unsuitable developments gubernatorial emergencies traffic admit ravine yelled
secure	southwards embroidered californium undoubtedly rendered extend
banished	bucket activated noticeably intuitive surge hexagonal elevating detachments
synonymous	scaffolding yearbook nominally ornamental nested yearning monster opposes underwent subtropical
minister	mammals indebted nanny instinct stewardship turned easiest recognise
adaptation	automatically dissolving accusing parameter textiles antiquarian tapped internally outpost noun
crossing	capable repertoire observation sticky solo imagined nature generator
corporal	complicity operatic restructuring parapet owners resuming arable live
historians	hint ionic string traumatic oppose revenge investigators attackers neurotransmitter steamer
royalty	reflect overlooking yard annoying laden tweeted youngster
slightest	spindle legged incidentally girlfriends happen tracked everybody seminars talents
hastily	hunted abducted skaters tourists incomplete laser yielded
renounced	replicating enclosing newcomer overcrowded unhappiness nasal commands exiles districts
stub	shallow throwaway unofficial buffer
petrel	prosecutor endeavors tunnel resigned estimating lady
spat	sentimental pieces aggregator thorns
attends	albeit territories twinned elegant normally deduces separates
assistance	albatross seminar southbound inch slim totalling accumulates nonsense cured epitome
paranormal	preface arias receiving amnesia narrate offerings retrieve motivate appease locusts
cans	combo adversary novels scenarios
shipwrecked	sudden hazardous inhibited parenting warmth relief emirate condominium knowing experimentally disarray
clones	charged labelled oxidation narrows evergreen sulfuric
rope	rumors obscured parting enlist
proprietor	parenting retaliatory officials pizza rentals imaginative extensive trail ordinarily ramps
urge	upriver refining gliding electrode
hospital	header others sanity pitted issues tandem angular ladder
shops	slogans hypnotic overlap phone subconscious
styled	style trains yoga linguistics energy domestically
convictions	cold outbreak northeastern vertebrae intensively crows teenagers irrespective overheard northwards swelled
subjective	suitability usurped backstory joined exoplanets challenger tearful inability versatility experimenting
governess	grove organize vest engineering revolve node extent swift sect
campus	capacities aired manufacturer persists under softer
triangles	tightly researchers irritation attention nearest grave launchers eastwards scares
vessel	villain editions suzerainty seems evolved lyrics
viewpoint	vanguard interpreter eternal wheelbase percentages organs inhabitants northeast themselves
responsive	realized emulate stock plugs output narrowest stereo imperative verdict extremely
adorable	agenda defied office rocks attractions budgets longtime embassies
pitches	patrols industrialist that chairmanship hyperbolic electrification sprayed
swims	southeastern wacky identifiable mitigate styles
wheeled	wind horned enthroned equilibrium lovely enigmatic domestically
shading	skepticism highway amino dwell irresistible negotiating grasshoppers
idea	innings denote essential appeal
remarkably	remedy effortless measured arena requesting knocked alligator bequest lakes youth
abandoned	activated berkelium attachments notched dissatisfied officials netted exists devising
baton	bony acquisitions timeframe overruns northeastward
plaintiff	pores launched adept interpret nominations tricks incoming floated fewer
harvest	hare areas rolled vertex exposed scant trip
solar	spontaneously officers launches alluding rams
cinematic	consist initiating narration erstwhile merry amplification towel integral countershading
projections	primacy regimen offset jackets exaggerated consternation trek injected observes nurses searching
begin	broadcasters echelon guaranteeing isotope negligence
populated	pious outfield packed unfair lore arms therapeutic electrolysis doubled
singer	sprint interdiction navigate graduates exports regular
reside	repeated educational sturgeon intrinsic deliberation excludes
parking	pelican applying recorded knock inspecting nativity generation
transcriptions	tending resisted alleges nominations sleeper constraints retailer inspirations portal throwaway important obnoxious navigational serves
iteration	imply troubles experiences raises astern tongue inaccuracies orthography nationalistic
inserting	initiatives newfound sabotage entitled recorders took intriguing named governess
incite	intriguing name compared inevitable traders enquiry
canned	covering aligning neared nomenclature electrodes delegations
famous	forefront annexed milder only uneventful stickers
mole	memorandum ourselves lies enroll
sticky	stereotype teammates investigation ceremony keyboard yacht
superiority	sixty unaltered pleasantly equalised revolves insecurity objections ratio inedible trombone youngsters
package	pupil admiral crab knots adhesive greenhouse expects
inspirations	intact narrates spent primates innings raging anarchists type identical offline northbound smooth
disappointment	detachments inflorescences supergroup audit presumption prospectors operationally industrialist noses thrill mythology expatriate nowadays teammates
pictorial	pointless inertial contrast tricked organist reprint invest advancements lunch
mantra	modest adviser nematode tracks recessive aptitude
audition	apprenticed unreliable discomfort implementation turns isolated opportunistic narrowest
flammable	fragmented lapse advocate moment molded archaeologists bricks labyrinth excused
projects	physiological retire opportunity janitor exponent cores taunting stunned
assuring	asserted subgenre schedules unconvincing respite insulation neck graphical
jeopardy	juniors elevating ordeal prophets anthropologists riding dissimilar youngster
silica	satellites insensitive limits initiated confessions arrays
capabilities	congestion airline persuades activates breakaway intersected livelihood incisive taller incidents equipment socks
requesting	resigned enhance quark unarmed electrodes strategic tight inhibits nursery guarantee
administrator	argon deified milligrams instinctive neon injections saga tropes railways appreciating target ours repatriated
tender	trail epicenter nuisance duchy elastic robins
thought	thoroughly hexagonal opponent upgraded graphically hoist transfer
frost	fabricated remainder overarching sponsor tribe
credits	conception restitution extradition dismantling inventor technique silver
counterculture	crowd orbs unexpectedly neutron truly eggs returner concealment unruly lodge theories ultra relayed encouragement
resume	referred expert statistic unprepared masterpiece easing
ridden	relocation influencing detonated departs encountering nationalities
scandal	steamers credit alternately nonetheless distinguishable authorize leanings
domination	decisive operational mitigate irregular native anticipation trailers indicator organisations neat
clothing	commence logistics organizer transmitter head intuition neared gradual
