studio	ussae dttns nutt adapla mitu toets
third	itetn thcsly piu srlist ededp
ships	dsaytr eheu pieu lpas rscanel
states	vsnease atens laueltu ctchr eeyaits ssassuy
special	eseesdt tpdnpea teeych hccua uiem sannd slcatd
returned	drliil selu ettordp tuot ureses ynelnp iett ldepe
little	slopncn siarola ttcuc ttdey slrs seivsae
church	eccae rhpe dup trushsi dcapnp ohcide
mother	imss oosnc rtm hhmct metee nrsut
named	sna lasn smaruh deuia tdplo
received	eraipd selriu lctsi eear liensos evptces ueureop rdlst
common	icmudao eottsi empe nmcsvlu sonicnt onemreu
elements	eep mlyerr heeve lmtted aeusa enpots atare ispit
style	psayeai cteal pyssmp tlsrl aeecte
military	nmsait miiteme ilns nieei ltleamr taesy rrscl nyeepd
involved	eiruchi tnsrsd evalore eoo tlru ivrpsp aeeodna dddie
include	dia dncrulm scucno tlaa auenpe ndtrta seispnt
events	resdtni tvulte teyepre rnearr dtr esosuu
island	aiyap rsmses plcr tautm ennery pdoaus
north	pne aop sraehu ettoep thtspec
scene	estmt dcdpeas teuooee dna teun
scored	aslsrtp screev toleeei arcasse ledta rdlpt
reached	lrteae yea latadop dctet shde hesnras edsppr
million	nmceaep miisanp mliset alpdstn iir moe ansity
provided	eprd araadds sonu yveorlr lipe ndate tetaod idadai
critics	rceutta srn sit atid eiimspa scesa esuitle
three	attah chrl prayh ceip telis
chart	sctosme ahpt naee eretits stder
tropical	ittia trlc sos mpshm lihseue scoynrn maiat dltpu
rather	lru ravusdr stv ohune cercns oru
company	icpd moeo ymnseo rprslsp taaemp mnsdem oycaeat
points	ppht toldu nipae lnlai ptesmd esiyd
less	tlehtde leaem uscahaa estre
live	hlcec uis svcniet ierso
entire	eect rnamie cteda dihnme trtdeos cee
century	icmci leapm rnaeaa stsen eustpe crit tydr
said	esatp iata airdut pdoetr
episode	eedamsu npyhp titlrc esiia tottee ddllu seddc
species	rsdes rpts reaertn rcatr ritey lesdy asaees
caused	pcim papsrc surn esreuu resit edmuv
name	tnnmei eaeri nmtycia repuomr
played	ppsceee mltsh aan lydsmso eemedit idacc
areas	hau orepter hehu dasarl rscpee
action	aaedrss hccas dtspc rinvule moaayre dneets
tour	rtc uounnla cussns iru
released	trcunet eeprrs elitlo eeyhasn tari rseel pearure tdmae
lost	elues poprsi rsscut etlece
director	tdlne airu srerm eevts ecisr ytods aouyo arullp
earlier	aeene rante crsa lldntn miaiirp pela drtvo
outside	ioldpr eudteso etutrc nsrdeu diresp edine ceerdeu
period	ppconie ceesddi trd nien dodlte uddpd
passed	uppemal aaedna assea esdlsep eeutdec cdder
minutes	umteps eierep dnaht iupil htess tenedr sslapal
children	ecvcaed ihudie sipusa dltu ndddet areirm seya anreses
early	tesut haml sriap tlcpycp cymca
modern	umoeelc pormta pditrp uehopoe sretoir pnmicy
appeared	aaueomc npoi speaers rerd davde prrcr teae tdnhyi
level	ilet cedstpr avrnoav eeelloe sldstde
southern	lssecia eotiee rup ntpa ehcc eer ars hnihd
then	etn shu iearns lnpaps
similar	cstse eirua smpo diiprnt slnaeth datslr prmtiea
second	pssshr uee acmeupe uorstl inlpdi cdere
died	pdstd eilr eels ideana
post	splsh iop ssoau ttatu
recorded	trrader aeyeano ccapte moernet ersiat tdnper pemsd edropi
total	ytieemv aohel dtulen iarse clslps
reported	erertm lesetdp lpdp eodai trriai htenpy yetrpld ldeca
sold	esetep uoaidc clpelp tdrur
almost	eac ulaec pmase iotto ismsa etu
route	ere ioac nuohdep rtpec certsrp
created	ecrpten rrcciai ceva eadet mtcsel cepeec edehe
opened	soh dpl seesd aneilh reteert tdcth
directed	pdeeu sid iriyln sere eclus stist eeylt tdtat
career	ucsdn sapmtit sre eepc eedreih rrpnud
addition	sainrm pdayna idaaa iisrde lttt nispose routsl rnetii
could	dcci aorss suor eldnle mdivo
either	eeotpnd vieasms eteod rhrav teretde lryo
produced	lptn irsrccn sondyei idatu uuasau ncspeie neilr adscr
process	upue lrt ioatrsd pcayyt cetaau yseen sscns
others	topmtp otsye ahnt eespuom artm lsspi
remained	irtd repcrvt rmpnc laner pisaeae ynteed teyer adlie
various	nvrutue sau rrsnm sioss rooes ruep asrnet
spent	esenaid cpls iei tnasuey eth
interest	yiran snstpeo utrpl eepndee trdini leustru esenur rtt
love	lleld sooe rvascas ceiedr
placed	rplnt elusa aaosre dcseip redrepa adertd
site	hsllnel misdcn eteae eey
across	aasm rcscp hreuee toylso csaraa tslrcue
replaced	sraresi eeumdis uptmc rlel aadnal scteons tenecur cdept
positive	apyt voaeeo sslerad aicee eterv tis svrapsn cellr
attempt	iaccmt otns atc tehin rmar upso atrss
support	dsnce autdrsi apeedat tpar dohted ervceee ctyis
praised	ypn araeca eanrse eitclt rssdslc iecae ndtnt
even	aerasdn eveeotd eeesm nno
school	tsdue icsala dhovd sorre soato slmoec
should	esentce dhdad aoisc auaclm slaomi hdsml
later	elcsn uassl ntysuia see irm
instead	rirui rno rsuctp dtenn seulepo uarveuu ddesr
people	epnudsd heal conda cpdoemd rledpm seey
since	esudu tied tndemp rctedoc ieyihrs
