amassing	fastball impassable sales useful associated distrust uncle agenda
millibars	impeachment cinemas cleansing claimant fields abbey halfway preference assessed
hurry	whimsical nucleotides arenas profound cyber
liaison	blasting widened mates pillar aspirations consequent anytime
neutrons	inserted pets numbering streamed originates sounding intervened psyche
revoke	trunk letter overlapped compassion skull reflexes
creativity	sculpted protruding revelation ballet stallion kickoff overcrowding list strip symbolize
ambush	backbone umpire ibis fumbled islands thus
unhappy	authoritative enable rhetorical maturation appointing open mystical
defense	adjustment perched effortless rebelled index asset selfless
secure	assigned selectively accessed junk crabs section
disorderly	advantageous mission espionage noblemen writer idea peacekeepers pretty clerk types
proprietors	spouse breeds locomotive spray breakthrough timetable designate sticks bookstore bright esteemed
loan	alderman forgiveness hazardous inserted
reveal	principles ceased avoidance rehabilitation jail alerting
voltage	overfishing borders altarpiece strengths career iguana reinforcement
posited	spontaneity positive ascribed microscopic station perimeter adjutant
aided	cameraman cited adherence peninsula additive
attendance	haste strongholds attending decimated internally additive sake intriguing schemes performances
vanishes	oversees lamented environment livestock asking thickness gears aspiration
holy	whaling southernmost flashes hydroelectric
either	dens riot strikeouts sheriff deserved brave
neutral	unseen metamorphosis bubble stuffed erstwhile massed classified
interactions	dichotomy interrupts ethics declined dreamed labelling scanned attire circumstantial posed enlists assessing
attempted	pays stigma sticking debtors empowerment optimum stimulation reflecting edged
allegedly	last plundered plains reviewing agony benchmark adequately claimants symphony
degrees	advances persuasive agriculture dragged relevant description essentially
iconography	liberating accuse nocturnal unaware posits agencies preschool mainline upbringing thrush mycelium
strait	assured strengthen drivers banking distilled still
coastline	scholar sons manuals escalated striking plazas pillars intakes sealing
twilight	steamboat swampy bind gloves lily aggravated theme attaining
dilapidated	ideas rivers else battle upgrades ninety ideologies raucous starving heats adorable
budgetary	abolishing autopilot identities eggs temperament attested capsized brief symbolically
secure	assigns declined scientist durable transporting beats
banished	abundant handing infringed hilltop established checks beaked ideologies
synonymous	escalators typically inconclusive forbids inspiration bypassing amongst torque audit usurped
minister	amazing financing enabled nightmares estuary strips verdict progress
adaptation	cavalry adjustment caravans opining utterly yarn utilitarian literate coaches antagonistic
crossing	scratched prerogative confer assembling assurance discipline incremental ignite
corporal	accordance dock ordained apprenticeship dozens protruding causes floods
historians	shops picket estimates strap nose trial discretionary wallpaper undo osmium
royalty	tractor colonists lyrically wading flame steamboat tyranny
slightest	associated cleansing dissident agitation cheeses stud responsibility estimating stationary
hastily	whereas party assumes status bind elevator symbols
renounced	orogeny recuperate knights colossal outside inshore schoolchildren peat advertising
stub	assessments statistics outs observed
petrel	speak denotes study crowns heats slap
spat	associations opaque valence stigma
attends	caring statewide stipulation rejected innovations adversely especially
assistance	magician psychology psyche disguise osmium strongest matched intricately echoes reorganized
paranormal	speakers called drinking walking unexpected convoy precise embracing baptism slender
cans	screened parachute individualism islands
shipwrecked	assume chronicles withdrew applications sweetness grateful resuming scores skilful beautifully identifiable
clones	scarlet pleaded pounded intercity recited escalating
rope	wrestling northeastern specifics realistic
proprietor	ephemeral cried locked spilled present birth tests stationary commission problems
urge	outbreaks bribes igneous detonating
hospital	shutout movie ascetic spent minimized statistical matured glazed
shops	astrology shortages courtesy aptly astronomer
styled	established steaming types electronics terms admirer
convictions	accessibility robot institute evidenced limestone octaves attic dissident hook unaffected assent
subjective	escalating bullets observations eject reacts scratches strove fission overboard vested
governess	aggregates hospitalization aviator reintroduced arrows innovation testified islands ascendancy
campus	acclaim fascinated emigrants speakers pulled aspect
triangles	utopian arduous circulation warmed insects aging bloom resignations ascribed
vessel	overflowing seclusion establishing astern reboot flies
viewpoint	avoidance disc version swords spurred soloists viable encamped standby
responsive	transcribed repaid escorted apples community annular osmium limb average reported
adorable	lacking adept docile credits earmarked obligation clashing vending
pitches	apparently miracles attachments sculptures whales recess escort
swims	psyche swap nitrogen smugglers astrology
wheeled	swine character tears yelled flex desk adjust
shading	assaulted these warm adjourned discord entered agriculture
idea	rival identity geographically baggage
remarkably	arose verge imbued lasted troubles skits galley absorb slang mycelia
abandoned	cafeteria abbot paddy interchanges admires composite uninjured terribly editors
baton	obsession haze staffed booths annexed
plaintiff	spine glide parents lighten interfaces stressful rivalries afterwards affiliate
harvest	thinner namesake protruding overheard teak assert stays
solar	ascribed coping alters rankings proportions
cinematic	occurring viable ensures retirement emigrate cadet standards simulating scan
projections	operations arming collapsing fjord retrieves accidental stormed given comic inaugural assurance
begin	obvious penalties ignited limp induce
populated	spontaneously polluted approaching rulings plot facing structurally generating advisers
singer	assimilation liners endorsement ages devise traversing
reside	crevices reliability escalators figurine address repressed
parking	upheld camouflage gradually skin virtue anxious agriculture
transcriptions	stitches crowd tawny understandable assemblies economy aristocrat midshipman sprawling stages tilted doing underdog ashes
iteration	eight athletics genres prints macho attributes midshipmen bolstered unconnected
inserting	disappointment ensured issuance feud professionally strata nineteenth environments agriculture
incite	airfield unwittingly acknowledge vitamins styles tells
canned	action haste unsettled interceptions leftover adept
famous	offender rammed embarrassment done supergroup assailants
mole	smiles competitive alternating versions
sticky	assorted strangled timid screen skin dysfunctional
superiority	assimilated suspect sponsoring retrieved tribes rises formalized promoting finest stealing hydrogen
package	spores painted scarce skip battery aggregation reactions
inspirations	civilisation unconditional assaulting specify first greatly magical attraction mixer cost unnecessarily ascendancy
disappointment	admits pitchers issues tangible upbeat apiece downturn discovers insufficient strengthening improvise segments intermediate starred
pictorial	aptitude tilted scale startling poll presidential pigeon ballcourt flipped
mantra	imperial faked snapping starred wrote haunted
audition	earmarked futility admit yield stereotypes richly monitoring inwards
flammable	offseason electronica mares ambient emissary batting above aluminum perilous
projects	applying crude tollway eject pesos accuses utensils assistants
assuring	laymen asleep assert pups practise piston android agricultural
jeopardy	eject reform compassionate specialty management trading ideology cyclists
silica	psychologists airstrikes illustration direction sculpted rainforests
capabilities	accuracy marry upcoming patterns observer wield clergymen diagram atrocities virtually beauty ascertain
requesting	trot weather squirrel bulls separating ashamed striking millennium underneath ugly
administrator	tapping idealistic embarrassing dinner angering viewed estimated stare princely hatch staffs towers proof
tender	attractions recommendation inhibit advantages redshift promoter
thought	steering shortlist collective publication aggregated threat stuck
frost	offices growers noted asphalt attempting
credits	accused trainees retainers adhesive citation otters assigning
counterculture	sculpture tourist ludicrous anticipation staunch rectangular orchestrated scarf burdened alleged strive sublime drains medalist
resume	president teens association functional employ relocating
ridden	erstwhile fireman editors advocated seabirds encourage
scandal	aspiring scenarios manuscripts uncle adversely barefoot closing
domination	adherence countering impaled civilian inert cartoons stability figured correlation anarchists
clothing	echo plaza contested statesman whimsical hillside enchanted ignoring
