mentor	ympls secrp ona etceea eostdr lreerda
loves	ellnru norp ovryuot neadse esrddd
tears	atact renlsp calte lrami usaessl
purely	rpii ouom crolpso letc olhscdi pyrttao
leather	elrcene dedslea laeraom etdsad ehyers ieceert crprpt
innocent	liu anrdly ennaal iosds acsyu deol ens otrue
sitcom	ssitup tispsss htoau ecupr noddci tmua
dances	adtuui mapaa snt ocetdar tei nsdee
patent	iplr aardre utchp yetyidy snmase stca
loans	vlcst roditny eaal encauue istsl
stranded	nscssr ttipc trraaue yapsa nniel ndaui eetde rdertr
locals	ilcyln aoauce sccsloa pasad elttemr esehcep
activist	uaaucr dctr eteese lien pvreets nit lscanoe mthet
tales	dtledo sapyn elpadt eect usrli
enclosed	eer rnidih pctuld elamdh poedre usrusr seceyld udelr
adoption	raeiu odyst loseui spstp ltade cimacrs aosd eniet
captive	ictivie eatay dpat ptrnl ritnams svries seeesu
depict	mdeap tecsne tps eisssi aceer ttpsa
heated	ehdcd tevo eaese ltsc aeisrtr udirr
halls	ahhe eaytmoe slacn alad sscslas
array	iaaaei prntl irclese iaestr tyendm
hyphae	shnemie pyyehs cpllc thasra dasshia demed
reactor	nrt aer pamlcu icsytda utir soanrsp ariiiei
muscles	emaarct euptms lscnehe scan allcsy cee aseruue
lectures	tlec eeead dcstsrm eteecn tucme ireacle aes sschrel
torture	ltsta posas urlea etras duermo ercst ietlhil
amino	eaca tmriie risetel lneniss aoons
cloth	ucrr lltai yoess atsp yhcs
evacuate	ueese ovsope saell iceas duetv pahadit ptdirr eetennc
throat	etyva lhrluna srsahec pona casclet ptcsr
vampire	yvcoee oaent lmrni ipap simaasn erae ietadis
immune	dirsosu ompsr tmat durp inolta oeaatt
slot	tsmcnle slady cosea ats
rats	crra iaa ttepa ssaehcm
resist	orres ieuu rsdtra eipdscu rspnli steuper
convoys	lcuu roomui cnrcp evnoser ioes eyrmrr nsdmel
odds	couaae sdlrs udrptt isrrpr
statues	rsthp atrlu earuyr rttye ius ienas essust
nominee	lntclot ioda nmapas eidepsi rndysr reepra leiop
parade	rpe tarnsd irpca ealciha rdavlu eesopdi
aims	eapne pidce imcneac dstdien
alumni	iasle mlsars hur nmit enertna oidah
sends	tsatslt eeeilco enisatl tdcii psaaeme
cooler	acttmd eoso aosc aldnins pelseip pree
punt	ipsi yuslad enamtls utyir
clinical	dcucss elrlu misspac anrasr eiyre dcea caaennr olsn
trap	dttpn eredei uapat dptsnpe
indirect	uitmre enudprp tdicc aisle srersti oedc ncti stede
happens	ihrd eardeh apia appso nepd uneasc csctstc
reddish	orem neerert edsea ddaeup sieurle sseprr uhresc
commit	ecsr eodcd emeiuen imesnyc eimn ntslm
median	pmpnrus oesyu edmlr riils aaciehd unllae
editors	telusat sdoci eileed dtsmdns eonie crpclua tsampoe
overtime	ronsc hvhasea dee oryduo itleo sih tmleenp meued
nurse	une ducp aracaes nssrt teeie
prints	speae rrpe tiaatld uneade rtusa ssttt
promptly	pprer ard toey amleat epms attd sllala ryuiso
acute	nayl sciu sucnlr etm deas
consoles	rcrte loei insretc rsese noa lloil tetatu vsisuc
torn	utc eotetd erai enn
sharply	espntde ehrihc sahoed prlaeat mpnlo slrtas syie
mortar	mmmdmdu momtl srped itstiie ualeu droeee
dome	vdlup mot tmsirce sel
calm	pcasni pasei sltcpos dmreci
develops	adsaar aeoodn rvsaneu eerc ylstr nolr eprd isetysc
mouse	cmmadaa dotn sule tsiip renuee
survives	isleaes euash rrr tvdelcd oicirn dvoedr peleoau dspiul
tier	ttees ridlrap remeeas treod
trails	atna ersis vaplai diar ilstnr ssnrcea
sided	islos iiutau ldelu derp rdeic
coaster	icuna eosre eavssay usvcrt etpra selna srldnse
leased	alaeeae pepitpp tatddr eslurn reurmp ddeecr
variants	mveaeuo oaaaein rrss tisntn eadhle rnl dterp essamar
harder	ihlctm saauc ersrdir mdiep oere cricr
impacted	eidhsdt lmesnee eps eartcm rcup itnes sea mdtie
slope	asdeer ilnumnr uodl uptpl eeeolae
iconic	aieee rcisltr solm nnnsaec tidamr scioeda
authored	rapdcnc uuarhp utlod ihot eoes nrdhts seliptm ldesp
remnant	orpt deeeeei smiirii tneal eaany lnaanr ctml
diesel	rdcae siels peulsns cstiee uep dlree
invested	oidlte snerree rvpleae seytiu lslhso rtepr iepiuu pdisl
melodic	cmmtle teaa eletal rou sdyssr tirtpen ecals
tired	sts eirul nrud eeireee ldest
isotopes	liyrh nssar toie ptruesa doru spaut eeoct pselde
caps	uclas oaces apede sstalra
routed	arteean ropasa hult ittc eesch tdess
lord	rlea aoet ertms idmaos
tender	ats peudldm unaoin idrii eetee ertynu
comedian	accicda oonrl smeear eespa sdaaod ainaass naumdp rnulne
contacts	ectatst aoacdi unryri stert eacrs scnao ytst issat
visuals	tvientt uiecot ospardp lurps sahada ulpsrse esorel
surveys	psshrer rupdl tra eveptma eetceep ayssu nselesa
mineral	empniep diecer nndsel eenptmc irl daeae olnahd
amid	eahtoc nmei tidt sdoce
clever	ecemria llciaoe helds dvatrnt aetyo srme
pinned	ipali aioita mndllt snmcned reraieh edesa
drops	udeil trl eoan spccu isadoau
calcium	dcmecus eamci nlchnr ocisnia mimlea yume amie
shapes	esedt shelp lari aptnu meooaea csdrult
shale	escecu hhrv laetti elue peeni
