mentor	amino senator inter strictly rode prints
loves	aliens horns overlap meantime assured
tears	strain depict lady triumph isotopes
purely	spirits nurse proven deity clinical pyramid
leather	slope depict vampire stomach thrust secular cream
innocent	yield ensured enclosed poets iconic deadline invested stunt
sitcom	assured rituals stranded accepts rode amounted
dances	editors dancer entirety iconic sends assured
patent	spur ramp steal lemur endemic steals
loans	clever monsoon rats indirect assured
stranded	assured strain trails saint indirect advisory receiver adoption
locals	alumni counted acute lauded client isotopes
activist	paths accepts strictly yield overtime rituals isotopes strain
tales	starter tales clusters sealed assured
enclosed	recall entirety screened slot loses assured reddish editors
adoption	narrator adoption torture spur steal tired coaster unrest
captive	schemes catches spur stunt yield overlap sends
depict	advisory recruit spirits yield acute steal
heated	photos remnant patent stomach deleted admits
halls	shelters halls plots planted isotopes
array	harder cream priests payments hyphae
hyphae	phases hyphae spectrum chaos variants sealed
reactor	prints hell patent iconic statute loses prose
muscles	immune nurse isotopes acute clusters lemur assured
lectures	cloth deity screened starter cure dreams relieve isotopes
torture	statues rope traces stunt runners prints deleted
amino	larvae amino tiny induced coaster
cloth	scripts clause possess steals sharply
evacuate	relieve everyday parade scripts auction larvae steals tears
throat	stunt shelters cream horn manual strain
vampire	overtime tailed emotion spirits hire crushed realism
immune	diesel emotion immune authored insect depict
slot	isotopes slot polls stunt
rats	pride narrator statute assured
resist	prone sends isotopes viruses assured statute
convoys	activist comedian insect overtime morale pyramid assured
odds	hotels adoption editors assured
statues	isotopes statues paths stunt cure neutron isotopes
nominee	innocent coaster emotion rituals indirect recalls resist
parade	spirits patron presumed parade adoption deleted
aims	lady pioneer amounted assured
alumni	narrator plots lunar amounted insect mills
sends	isotopes resist entity admits isotopes
cooler	activist locals hotels client medley drops
punt	opener ruined invested strictly
clinical	scripts alert rises unrest hiatus schemes captive alumni
trap	stunt priests captive spur
indirect	divorced induced odds lion premise remnant schemes statues
happens	phases harder appoint spectrum melodies entirety assured
reddish	dreams persona editors admits tier assured sharply
commit	scripts morale employ amounted silence stranded
median	impacted leased odds pioneer lauded ancestry
editors	mere admits sided strictly convoys prose assured
overtime	cooler overtime resist criteria statute diesel amounted meantime
nurse	insect summoned priests isotopes sealed
prints	spirits proven sitcom inter steals isotopes
promptly	spur promptly mount amid spectrum stunt slope pyramid
acute	tailed schemes surveys stunt sealed
consoles	accepts comedian endemic isotopes sometime slope resist assured
torn	strain monsoon array entity
sharply	isotopes phases narrator promises appoint cloth pyramid
mortar	smallest commit prose strain hailed criteria
dome	odds hotels amounted revenues
calm	scripts maritime client smallest
develops	admits resume overtime relay slopes polls spur assured
mouse	employ coaster muscles isotopes resume
survives	assured lunar priests overtime divorced everyday helium isotopes
tier	stranded rises sealed traced
trails	starter drops saint viruses plastic isotopes
sided	assured diesel advisory depends odds
coaster	schemes counted ramp assured statute deadline promises
leased	clinical melodic variants assured meantime odds
variants	everyday lady prose sided lady interim statute assured
harder	sharply variants proud advisory meantime triumph
impacted	riots employ opener larvae screened statute deer odds
slope	assured plastic soccer spore leather
iconic	aims activist possess inter aims screened
authored	manor purely steals shirts touched pride resume adoption
remnant	array melodic impacted insect parade entity strain
diesel	admits rises leather assured receiver clusters
invested	viruses insect overlap leased assured strictly reopened odds
melodic	emotion senator clinical lots editors pinned iconic
tired	statute silence promptly mentor adoption
isotopes	riots assured possess statues horns spore declare isotopes
caps	acute saint spur assured
routed	prose loses outlets stomach deleted adoption
lord	clause commit presumed advisory
tender	stomach depict ancestry admits relay trace
comedian	scripts coached smallest hell editors virtual catches entirety
contacts	activist polls enclosed stunt vampire screened starter assured
visuals	evacuate mills isotopes punt paths client isotopes
surveys	assured currents array evacuate hectares pyramid assured
mineral	amino miners ancestry resist trap ears slot
amid	valid impacted visuals odds
clever	acute platoon develops overtime lectures trenches
pinned	opener tidal ancestor ensured deity odds
drops	editors trace commit spectrum isotopes
calcium	iconic variants slot activist lion muscles emotion
shapes	assured phases calm appoint depends isotopes
shale	assured shapes canon clusters lecture
