malice	melodies amid lecture innocent commands editors
decor	devised entity corn overlap rats
holed	hardly onset lectures erupted depot
purest	promptly unity recall entity scripts trace
pastime	proven authored sounded tailed insect medley endemic
mistrust	mineral invested stranded tier reopened unrest shooter thermal
revamp	routed ensured variants amino mortar peers
shoved	statues hell onset virtual employ depends
solves	strictly onset lecture viruses emotion schemes
pelts	purely ears lauded tears shoots
prelates	promises rituals enclosed lunch advisory tailed endemic shirts
coyote	chaos onset yield odds tender ears
credence	clever revenues enclosed disco entirety nucleus corners everyday
spicy	slope pinned interim catches yield
scandium	shirts criteria aliens nerve deleted invested unhappy miners
replayed	resume editors promises leased acute yield endemic disco
cellars	criteria emotion loses larvae aims rises strictly
tosses	touched overlap sharply stomach employ scripts
valour	viral advisory lion outlets unrest reunited
laird	lectures appoint indirect reactor develops
harem	hiatus assured rode entity manned
taunts	triumph ancestry unity nominee trenches sitcom
steeple	secular trout entries enclosed promises locals emotion
cheeses	counts harder erupted entries surveys entity spans
cauldron	counts alter unhappy lectures disco rituals odds nurse
plainly	pioneer lots amounted innocent nucleus leased yield
runic	rituals unity nurse impacted chaos
roast	rises opener array sends tier
marchers	mount alter realism criteria hectares erupted riots slot
reload	ramp entity lectures outlets appoint devised
hepatic	happens evacuate plastic anchor trails invested clause
primal	platoon ramp inter median aims lord
ante	array nerve tends enclosed
mace	medley authored contacts emotion
sentry	servant enclosed neutron tailed reddish yield
impasse	innocent manual particle adoption shipyard soccer entries
heed	harder editors enclosed dancer
annular	anchor narrator nerve unity loses advisory reply
adapter	alert deleted amounted patch thrust editors rituals
rupees	ruined unhappy plastic evacuate entirety spore
undo	unrest narrator depends outlets
scutes	servant cream unity trenches employ scripts
erode	entirety resist odds depot evacuate
pulsar	purple unrest lecture shipyard appoint ramp
uric	unity reunited impacted calendar
pretense	pioneer recall evacuate trout employ nucleus slopes entries
prep	portrays reacted entirety proven
cutscene	captive unity thrust sitcom cloth enclosed nerve employ
soundly	steal opener unrest nerve deleted leased yield
patched	purely accepts tidal corn humorous ensured disco
pincer	pioneer indirect nurse convoys entity recruit
voodoo	viral overlap odds demon onset odds
ailment	amid innocent lots median employ nominee throat
returner	routed everyday tends unhappy relieve nucleus enclosed reactor
ulcer	unhappy lion convoys editors ruined
sirens	stomach induced rope evacuate nurse servant
escalate	erupted slot clever aims leather array trout editors
clams	careers leather ancestor memoirs spur
covertly	convoys overtime variants endemic ramp torture leased yield
dice	deleted immune crushed entries
toddler	traces odds drops dancer leather entity rope
sacral	seasonal ancestry catches rope alter loses
vase	viral aliens strictly entries
stun	sued trenches unhappy narrator
aldermen	acute locals deadline entries recalls miners editors nurse
phyla	pyramid horn yield lord auction
tricolor	tiny recall impacted calm onset lunch outlets routed
tint	trenches immune nucleus tired
hectic	hell editors caps tales impacted calendar
patio	persona alumni triumph inter odds
inhaled	immune narrator honest ancestry lectures endemic divorced
driest	depot ramp indirect emotion statues tailed
contours	calm opener narrator torture overtime unrest riots stunt
candid	crushed array neutron devised impacted depict
prairies	phases riots authored insect rises immune editors slope
delle	detect employ lauded lauded employ
masons	meantime anchored saint opener neutron saves
carousel	calm amino rises overlap unhappy sharply employ lion
hideous	hyphae invested diesel editors overlap unity seated
laymen	lemur assured yield mount endemic narrator
nepotism	nerve enclosed premise overtime touched iconic spore maternal
prudent	plots rituals unrest dances evacuate narrator trace
aptly	advisory prone tailed lecture yield
minstrel	manor insect nurse sounded trails ruined everyday lecture
hash	harder anchor silence heated
cation	creators array trace invested odds neutron
shin	spectrum honest innocent nerve
chimes	crushed hate innocent median evacuate statues
overseer	outlets viruses erupted reply soccer ensured ensured ruined
overruns	odds viruses emotion rope reddish unity neutron senator
tripped	thrust reactor interim punt photos endemic deadline
ovaries	outlets vacant authored resist immune editors strictly
elapsed	everyday loves adoption purple secular enclosed demon
spec	spur priests erupted crushed
hearth	happens emotion array revenues tender hate
hipped	hyphae insect promptly planted enclosed disco
eater	ensured amounted trails editors remnant
sulphur	starter unhappy loses priests honest unhappy routed
stylus	shirts tier yield lunch unrest summoned
prima	persona recruit isotopes manual activist
