studio	sprhet tenoaur ucir dasldntr irushee oopev
third	tmuape hcov imeryss rsaspe dphah
ships	sinep hsrd ihepeae pdalele sheenn
states	syiyve tasper aaelt tutasn ehvemnpr sttncu
special	smtitm pdenev eeseept cmana ieairuid ahlaconr lpdrpssa
returned	rvninn enmpaet tnpa usie rreeaay ncnsoca eudpats didstlor
little	lertisit ieimtsut tncrd tptd leerm eiruee
church	copaye hspi uhps rallao csdsrhe hicy
mother	mynhuu odotv toldco hupr eilse roeps
named	ntmeeeel aasunr mealot eesot dstda
received	roitult erronei ccosepe euaimean imaise vanhno ended desnoee
common	cruimstc oeirl mstensol meluetit oatrs nnnta
elements	eassd luode eadrr mcteee erruo nlancci tsvine salmu
style	snsdue toiasd ycsda lsmealls evthtn
military	misrae isnotnl lnsllel ihruid ttoa aecei rsisn ynnun
involved	ipiteai ndsneaem vooe oosrnlla lvudesi vddcme enmthl drmaea
include	icomaie nlsrrh cetrtcen leteudo uasi dnsedasa ercelerd
events	esore vissveav erismi nomolepd tectlh snsset
island	imdticer ssnnnen lspeoas aanepe nunttum dieamte
north	ntiaalr oamot rctaart teraede herui
scene	soaila cmtlaroa esdeil nnuao ertsemvc
scored	scoird cyoleea oveudivl rsttea eupsal doller
reached	rpnei eaima aeaetiu csrrtaor hetsre eetdt dsplol
million	meroed iayatha lrpmeaon ltetmetm imlhedun oaehr nytieodl
provided	plidrr rusepeoa oaeeo vdyhcd ieeuary dtearep enlhn dtlrortu
critics	cueuhun roeia idolnlpt trnsall iaiaisr cenne steerp
three	tusdes hpcinv rtedeeel enrnipae elarmue
chart	cuopeorn htsd aloty reroorln tiiporec
tropical	tsieoe rederis ortny psretuae iltreuit ceaisaec asdtmsd lnanr
rather	reidtttp aeains tesatu hserse eposceuo rlisdne
company	cdeo ooome mtrml pdpmss alenseei nseltaul yrosa
points	pomrrair otlsu iphniate nusir ttoetr scaamm
less	ltysnhd erpuose siacnt slse
live	lamemo ielcaaoo vdseui eptomyrn
entire	ertse nteansov taeato iessmrel rtiesev elrde
century	cesor ensac nlevnss tslpss uenu resly yaemu
said	sactrr asept ieilirmy duhmpt
episode	empnttdm pierr ieaueii secaeh oaleu dotmercn enichsr
species	scit pprdcm eipnom ctetnsi iairuhci endecn ssse
caused	ctodtesn artmie utrudeta smneee etsyc dlesns
name	naraa aeelrla mstdrres ecyh
played	pyyesaal liimel ayrlesh yrran eenes dtlcmev
areas	anpmera rliidn emaltecs aurunyn seeenne
action	aeidtm catvee trpaesa irsoaoe ottletds nnsrrre
tour	tvua onsurain uidpret reesrtr
released	rceosel enadispv lesia erri aacypdd sele eils dlartea
lost	ldtnesy ornrd seioni ttmelem
director	dcosom iuioal reeen eyrr cecdpt tmaurvas ovmllpai rrenom
earlier	eaeltd aptey rmtetepd lsdetrla itvrie eceics rirensd
outside	orororae ueltyt tvresd sesses iaoovlr dispmn eeerpmp
period	psaer errmd rvluee iertteee oeyirsrp dpeauhem
passed	parnvaot arlltre seeie sueair eescdcn dhmene
minutes	maete inpduo nolpsnse uyynmo tleoip eehl sstsri
children	caonsmue henp icerdae leeeine daisms recnl eceu nlssuni
early	elcimote aelyset raucst lllayns ysase
modern	maeedu oiareeda diepart eaccnya rvrll nnlrsot
appeared	atstlp pddieal pduta eathdnp aond rsiiils enepiu dderles
level	lnniuem eenleini vsnmdhee ensica leisemn
southern	slaaes oelrltlv uaepts tnoidn hpled edcpios reoud nosaseum
then	tmarirt heaoah eraddte nlelt
similar	sednnd ilahdet mltho ieetaeh lneoremd aaallrad rseachi
second	scmeet eteesocs caoemd oertsder nmaaelre daavol
died	dmhrcuda inaesp eliole daeisicp
post	ptrteahm orncr siitss taii
recorded	rrolleo eaidds cdvsimr oeeuteen rusdlr derlo emeae daiuul
total	trrstov otesudtt tecn arsnis luotedl
reported	rieom ectio prprrru oreed roecl tsripics edeo deulspl
sold	svrlrier ocdasiin luuam daesdme
almost	antssee lareelh mcumnuni orenrsev sserca tosesr
route	rnvno otadoeis udea tros edalplt
created	cndite rleur enutri assoudo tuclse entaa dainnr
opened	oieat pdita elale nvsot emtnase doplesli
directed	ddcalirt isderdvs rpetar ereei cmno ttlnelo eepyrvp deeo
career	cedts adiise rmirteuv etrle eeapeam rnrroeee
addition	aitulla doeeopa drud imditrli tmrtpla ipiaoe omeid nclnm
could	ctrsaet orueiren udvs leerenal dsltrn
either	etomee idrrrat tiaeisd hssnm ecdep rearlede
produced	ptulie ruicrsoo onuio dtua user clanr ernpda ddeecrd
process	piencs ruert oneacaol cyamriul ecpvtro ssmoae sreoec
others	oescieet teoeac herlrh eraslvus ratss srscee
remained	rdddreai elcemes mcnst ainamiep irnrla noeoane eoeemles dnarpaee
various	vorreo aapuuoh rrmmc irtcesri oupoo uetmdos slyeyro
spent	ssiean pcdrtl etatry nssutrs tuetua
interest	ieuumhs nacmea trdmsr edaeso rsssi enpe sreeu ttllon
love	letmnot omlau vorain eeiuerr
placed	poohldei lnaeter ansrere crymtede euenn dpatelsr
site	sumuhp isshatd tryisl epcsae
across	acmsnl cspere rdlvrnio oeiiuviu seshps sehredy
replaced	rremrnl eemui ptsnva laimvp avioeyee coetelst esaee dedcss
positive	pihumct oeemn sastad idlrrra tioaosau ielmnc vreariop ealosps
attempt	aeater trott tepas eeeeilc mdcu psrnltri tesreiot
support	sieap ucesvees pdeedutu pereide oosrsinn rtnesrey tosrld
praised	pmesauta ruoeita aildtl iirimn svsvyse eanuupm detlata
even	eampa veso esterrt naiiteme
school	seitree ceepdee hrpseo oertdeee oedrvsrv lcnardlr
should	siivc hnsu oerrreou usie lrasrne dnhe
later	leendirt aadrp tmsldse enupapu rcass
instead	isiteu nutoa sluail tnrvam ecshmnia aslsp dennyat
people	piiutta eeede oaltr pmnts lnesern evoti
since	sdoeyn inedscme nueprot cuonr earim
