malice	small east class list across served
decor	added result scored total created
holed	three move player served addition
purest	spent support created years used states
pastime	appeared said island style million small years
mistrust	small times island story areas success used others
revamp	produced heavy ever match small species
shoved	used third sound event service addition
solves	used command players even very island
pelts	open recorded player style used
prelates	species ordered century played said studio returned island
coyote	school noted system located other served
credence	action tropical central added death include scene returned
spicy	used upon live action system
scandium	island across passed until addition similar outside small
replayed	ordered heavy appeared placed later system remained added
cellars	scored year played claimed same provided used
tosses	state does used island very used
valour	over have player south human process
laird	close land video present addition
harem	them days army death small
taunts	still match music include story used
steeple	island start people lead spent play reached
cheeses	action ships replaced period island near island
cauldron	action parts such players addition previous house entire
plainly	upon close case lines involved claimed system
runic	created such interest list scene
roast	previous points name used storm
marchers	small east ordered action chart replaced provided island
reload	present lead players post party added
hepatic	should received spent said states victory scored
primal	open praised little small parts players
ante	came instead stated heavy
mace	small made across decided
sentry	used service instead still praised system
impasse	time small episode main used island central
heed	these served recorded addition
annular	national once entire human played late army
adapter	last addition each upon still people around
rupees	army support open second received used
undo	turned until added months
scutes	island scored human started death island
erode	remained created position added release
pulsar	special must placed used case order
uric	much previous director action
pretense	opened area central station version instead island year
prep	appeared around return open
cutscene	scene support story used across second another season
soundly	used common must entire added almost system
patched	episode case storm scene them term added
pincer	appeared since another school section area
voodoo	over month post added common command
ailment	early list placed small record ended other
returner	present returned other such produced instead lead praised
ulcer	runs placed scene death troops
sirens	used list praised decided ended used
escalate	level island scored cast play various studio reached
clams	scored almost cast small island
covertly	across move even decided ordered others play system
dice	addition time action remained
toddler	station house added addition played service provided
sacral	used main scene produced name played
vase	over case used reached
stun	island story outside units
aldermen	various place addition very present small rest entire
phyla	special third system players career
tricolor	storm present line scored month placed company tropical
tint	others either units attempt
hectic	short served scored others directed scene
patio	species cast studio list love
inhaled	list entire three career almost near added
driest	added troops list record island state
contours	school country instead other northern runs tropical used
candid	across late ended added city addition
prairies	spent process passed miles present minutes season used
delle	addition sent players place return
masons	small various used months interest used
carousel	action match provided sound such island year player
hideous	chart lines addition section post support used
laymen	also name system small despite entire
nepotism	instead released open sound style title island small
prudent	episode praised music added seven include attempt
aptly	part opened state player system
minstrel	small list interest island story army series placed
hash	these caused used than
cation	scene name other directed located only
shin	island that since involved
chimes	school ships city small central island
overseer	court ever never area island served reported process
overruns	points over years army troops support into used
tripped	station troops title open species years added
ovaries	position over many army since lead used
elapsed	several players made special island decided addition
spec	used species released across
hearth	third service race area other should
hipped	ship site opened opened held added
eater	level various studio period ordered
sulphur	island turned claimed species those human tropical
stylus	island states system place outside island
prima	species created nine small early
