mentor	military event north they over reached
loves	local only video episode story
tears	than event appeared reported style
purely	played units released each land years
leather	little early also term heavy ended reported
innocent	island never named others came entire noted this
sitcom	site include them country over more
dances	despite area northern city either ship
patent	process appeared those east near tour
loans	level only areas never shot
stranded	station tropical rest areas named director events died
locals	last open caused also lines storm
activist	action central three into video into service then
tales	turned army love ever story
enclosed	early named class level opened short ever despite
adoption	attempt died opened play team include order national
captive	control almost popular title into various entire
depict	decided entire play include central title
heated	hours elements around those east does
halls	house action live lead seven
array	also received released another years
hyphae	have years provided house also event
reactor	return each almost children team once remained
muscles	minutes used support close list ended some
lectures	least early could time until result even small
torture	their over reached time units runs early
amino	also months included nine opened
cloth	claimed love once told help
evacuate	elements version appeared central used another team early
throat	then have role other another than
vampire	various area must point include reported even
immune	instead moved made until near entire
slot	section later opened them
rats	received across turned start
resist	rest early sent include spent they
convoys	country only northern very once years similar
odds	once died despite series
statues	seven tropical areas team units east start
nominee	north only month interest noted episode east
parade	party also returned addition despite even
aims	almost instead much states
alumni	area level upon many near island
sends	same ever named despite stated
cooler	come others others lost even released
punt	produced used noted title
clinical	come lines instead named included come attempt love
trap	their role army process
indirect	included north director interest received early class those
happens	history addition passed praised even nine story
reddish	record early directed does into section heavy
commit	created ordered more moved include turned
median	military entire decided include appeared northern
editors	ended does island title others return station
overtime	others victory episode rest told involved most early
nurse	near until release station either
prints	player recorded instead name times storm
promptly	part road only month people then lead years
acute	addition command used turned early
consoles	come over never said outside later earlier site
torn	term other result north
sharply	such held addition reached part little years
mortar	military once remained their area release
dome	days opened minutes elements
calm	city another less miles
develops	directed episode victory every little other praised success
mouse	mother once until service elements
survives	success units result version included very early special
tier	told into episode remained
trails	term role across involved love section
sided	scene involved director ever days
coaster	chart opened added still there event release
leased	least every appeared sold early death
variants	version area rest instead another northern than studio
harder	hours addition result days elements record
impacted	island most players around chart third either death
slope	since level ordered period earlier
iconic	island common order nine instead company
authored	almost under three head other record earlier director
remnant	rather early made nine another national times
diesel	director involved event season ended love
invested	included near various episode states team ever despite
melodic	more early located order decided involved country
tired	term into role every director
isotopes	involved started other those over produced elements served
caps	cast addition party second
routed	role outside used team early days
lord	last others return despite
tender	that events national death episode reported
comedian	created only minutes entire death involved addition noted
contacts	caused outside name term area company these some
visuals	various interest second until across local same
surveys	sold under role various earlier year second
mineral	much include name episode route added least
amid	added miles included despite
clever	came least earlier video ended release
pinned	provided include north north elements directed
drops	days route other passed site
calcium	caused area local close include used match
shapes	scene have army post elements sent
shale	storm head also located ended
