mentor	memoirs emotion nerve thrust odds reunited
loves	lord onset visuals erupted summoned
tears	trails emotion appoint rope soccer
purely	plots unity revenues editors locals yield
leather	lunch editors amino tired hire entirety rode
innocent	insect nominee nerve onset clusters evacuate narrator tier
sitcom	spans immune tends corn overlap mere
dances	deity adoption nominee corners emotion sharply
patent	payments alumni tiny evacuate nominee trails
loans	lord overlap aims neutron surveys
stranded	screened trails resume amid nominee depict ears deity
locals	lunar onset chaos array lord sits
activist	advisory chains trout innocent virtual inter sealed tidal
tales	trace amino lion entirety spans
enclosed	entries nucleus captive leased opener steal endemic depot
adoption	admits depict opener proud trout innocent overtime nucleus
captive	clause alert patron tears indirect vampire employ
depict	dome everyday promptly impacted catches torture
heated	happens employ adoption tiny entries dances
halls	hate alumni loses loses sends
array	auction rope riots alter yield
hyphae	hailed yield parade horn array entity
reactor	runners enclosed accepts corn tender overlap rode
muscles	melodies unrest smallest caution loans endemic stunt
lectures	locals ensured compose tidal unrest rituals editors sometime
torture	trout onset resist trout unity recruit employ
amino	ancestry melodies immune nerve outlets
cloth	commit lots overtime tired happens
evacuate	employ variants alter chaos unhappy auction trace endemic
throat	tender hiatus ruined overlap array tailed
vampire	vacant aims mills pyramid indirect reunited editors
immune	inter maritime morale unhappy nurse entries
slot	silence larvae opener tiny
rats	runners amino tiny shale
resist	relay ensured spore inter shelters trap
convoys	conceded overlap nucleus virtual onset yield shoots
odds	overlap detect depot shale
statues	sends torture ancestry torture unhappy endemic screened
nominee	narrator opener mortar indirect neutron entirety employ
parade	prose aliens receiver aims depends everyday
aims	alumni isotopes mortar shoots
alumni	appoint lectures unrest morale nominee immune
sends	screened emotion nurse demon spore
cooler	criteria onset onset lion entity routed
punt	patch unhappy neutron tired
clinical	contacts lectures impacted neutron insect calm adoption loves
trap	tears resume array prone
indirect	innocent nurse dancer immune rises entirety caps tender
happens	hectares amino poets purple employ nerve screened
reddish	rats ears dreams demon impacted saves horns
commit	cure outlets memoirs manual innocent torn
median	maternal erupted divorced immune accepts nominee
editors	ears deadline indirect tears onset rituals servant
overtime	opener vampire erupted remnant torture immune meantime ensured
nurse	nominee unhappy reddish spore ears
prints	plots reply insect narrator torture senator
promptly	patch rode onset mills pyramid tailed lady yield
acute	admits clause unity traced evacuate
consoles	clever overlap nominee spectrum onset lemur employ sounded
torn	tears onset rode neutron
sharply	screened halt ancestry recruit pride lecture yield
mortar	melodies opener rituals torn anchor realism
dome	deity overtime manual ensured
calm	cure anchored loses melodic
develops	demon endemic variants evacuate lecture onset polls shapes
mouse	manor overlap unity shed employ
survives	survives unity runners valid innocent valid editors sends
tier	thrust iconic entries rises
trails	triumph reacted alert interim leased stomach
sided	spirits isotopes deleted endemic demon
coaster	careers overtime aliens sharply tidal erupted reopened
leased	leather ensured authored sometime entity deity
variants	valid alumni rope innocent alumni narrator tender statute
harder	horns alumni revenues dome endemic reopened
impacted	innocent median papal amounted conceded torture evacuate demon
slope	sometime leather onset premise editors
iconic	insect cream odds nucleus immune client
authored	ancestry unhappy torn honest overlap rope enclosed dances
remnant	rises editors mineral neutron advisory nominee touched
diesel	divorced innocent enclosed silence employ lauded
invested	immune nominee viruses ears sided trout emotion diesel
melodic	morale everyday lunar overtime depict inter crushed
tired	tier impacted resume entries deadline
isotopes	immune sounded opener trace opener punt entries slopes
caps	crushed anchored punt sitcom
routed	rats onset unhappy tends enclosed drops
lord	lion outlets rode detect
tender	tailed erupted nominee dances editors recruit
comedian	counts overlap muscles entirety develops impacted authored narrator
contacts	contacts onset nerve throat alumni currents tailed shoots
visuals	viral interim statues unhappy aims lauded scripts
surveys	silence unity routed virtual employ yield strain
mineral	medley impacted neutron everyday resist admits lunch
amid	aliens medley induced depot
clever	comedian lauded endemic virtual ears recruit
pinned	priests innocent nucleus nurse endemic deadline
drops	detect relieve overlap particle sealed
calcium	compose acute lots cure induced unhappy memoirs
shapes	shapes horn aims promptly employ sometime
shale	shelters horn advisory leased editors
