malice	eminence eater classy dice scutes decipher
decor	edicts heed screamed solace urns
holed	cheeses couplet slander lenient edulis
purest	aphids hurled prima decipher astute utensils
pastime	aphids malt astute starch airspeed emirate deletion
mistrust	eminence tint usurper stylus tremor lures astute starch
revamp	trite detain overload narrate impasse spec
shoved	usurper cheeses covertly overload pelts adapter
solves	usurper contours ulcer overseer lenient escalate
pelts	spec recur elves steeple escalate
prelates	spec prairies returner plastics eater starch recur escalate
coyote	scandium morphs nymph voodoo stair nepotism
credence	scraped uric dentary adapter deadpan entropy scraped peppers
spicy	escalate spec hideous scrum mycelia
scandium	astute scrum cavern undo adapter siren runic emirate
replayed	urns recur aphids plainly landmass typhus revamp edulis
cellars	screamed replayed elves alchemy sacral tricolor usurper
tosses	utensils lorries escalate usurper revamp escalate
valour	overruns valour ulcer solves ruinous uric
laird	slander laird linemen prudent adapter
harem	phyla marchers urns dentary imperium
taunts	starch cadres curtail ante stylus astute
steeple	usurper attest hepatic relays spec slices reindeer
cheeses	screamed chicane decipher heed usurper heed astute
cauldron	screamed mannered huia aldermen edicts prep commoner undo
plainly	upload elapsed cathode dined undo elves mycelia
runic	prep runic ante hideous scandium
roast	driest soundly cantons usurper stair
marchers	emirate laird prairies screamed sheen secede erode usurper
reload	credence pelts alchemy soundly malice adapter
hepatic	chops returner aphids campy stylus airspeed scrum
primal	aptly prep diocesan eminence ravines aldermen
ante	marchers anytime stylus cellars
mace	impala caravans scraped decipher
sentry	escalate lenient inhaled stylus driest mycelia
impasse	linemen impasse spicy macho astute escalate heed
heed	chipped replayed reverts edicts
annular	mayhem undo unsuited lurid elapsed narrate prelates
adapter	ravines adapter cauldron spec starch deadpan tripped
rupees	prelates curtail aptly revamp dentary astute
undo	aunts unsuited edicts politely
scutes	astute scraped sulphur steeple meanders escalate
erode	secede precedes locusts edulis reindeer
pulsar	aphids ruinous plainly escalate vase urns
uric	aunts precedes sirens scandium
pretense	aptly urns sentry stylus yells inline astute hectic
prep	spicy troupes reindeer upload
cutscene	screamed runic starve usurper screamed reload annular secede
soundly	astute colon runes ante edulis slices lymphoma
patched	spicy patched starch screamed chops relays edicts
pincer	spec ailment anytime scrum lenient trite
voodoo	overruns sonnets commoner adapter molded voodoo
ailment	masons dice ulcer eminence yells annular steeple
returner	erode hearth steeple runic tremor undo deletion prima
ulcer	outro alchemy scraped cellars tremor
sirens	usurper hideous tricolor replayed inhaled escalate
escalate	replayed astute scares mayhem slices caravans attest relays
clams	screamed aldermen mayhem omits astute
covertly	screamed sorcery overruns reindeer prep attest ulcer mycelia
dice	adapter sirens scandium deterred
toddler	stair commoner adapter adapter slices delle tricolor
sacral	astute candid scrum arrayed malice alchemy
vase	overload vanishes usurper dentary
stun	astute steeple runic ante
aldermen	vanishes classy edicts peppers credence impala hearth undo
phyla	spec chipped typhus classy cavern
tricolor	stun prelates sirens screamed commoner plainly pompous uric
tint	stun airspeed inline attest
hectic	shoals decipher scares utensils hipped scraped
patio	spec savior steeple linemen coyote
inhaled	sirens undo shoals landmass slander hepatic adapter
driest	adapter prudent dined peppers escalate stair
contours	scares solace entropy steeple polymers supper uric usurper
candid	screamed taunts anytime edulis diploid adapter
prairies	spicy trite mannered sirens prep siren eels usurper
delle	edicts hectic plainly elapsed sentry
masons	emirate pastime astute molded ante escalate
carousel	scandium saline prep holed runes usurper returner elapsed
hideous	chops siren edicts relays tosses hurled escalate
laymen	clams vanishes nymph eminence lettered ante
nepotism	inertial returner aphids moulds starch ailment usurper impasse
prudent	spicy prudent rupees edulis cellars unsuited starch
aptly	pastime spicy stair alchemy nymph
minstrel	emirate diploid anytime usurper stylus prudent hearth plastics
hash	shoals hash astute phyla
cation	scandium narrate steeple pianists holed anytime
shin	usurper shoved siren unsuited
chimes	scraped chicane pincer impasse eels usurper
overseer	hoop overseer nepotism prairies astute eels nepotism credence
overruns	moulds overruns deletion prima prep putative inertial usurper
tripped	attest urns mistrust spec aphids revamp adapter
ovaries	consular overruns eater troupes hipped hepatic astute
elapsed	eels ulcer cadres spec usurper reindeer adapter
spec	astute spicy hearth scraped
hearth	shoved nematode cairn precedes stun shin
hipped	shin tint aphids spicy cellars edulis
eater	nepotism cairn attest reprieve pretense
sulphur	escalate cutscene aldermen spec chicane runes pretense
stylus	escalate starve lymphoma elapsed hurled usurper
prima	aptly prep minstrel omits hash
